height,width,area,max_row,min_row,mean,median,hw_ratio,burst
15,63,945,151,136,0.6069349792316672,0.3567772414745238,0.23809523809523808,0
22,92,2024,187,165,0.6352320425923809,0.28147410973174714,0.2391304347826087,0
23,74,1702,187,164,0.5977758995515188,0.381986305243393,0.3108108108108108,0
33,47,1551,187,154,0.5003886196922632,0.0,0.7021276595744681,0
21,56,1176,176,155,0.5459513116378437,0.0,0.375,0
26,42,1092,148,122,0.5830359627232846,0.43472949481520184,0.6190476190476191,0
24,57,1368,187,163,0.6696472032597011,0.4145734131585282,0.42105263157894735,0
23,59,1357,148,125,0.5893370696151212,0.3435061186232751,0.3898305084745763,0
23,99,2277,187,164,0.639019224014041,0.3341239801571519,0.23232323232323232,0
40,93,3720,146,106,0.48743308049738726,0.22152547781989088,0.43010752688172044,0
16,59,944,119,103,0.6572161909982643,0.5418484373780718,0.2711864406779661,0
74,203,15022,104,30,0.6346615101342168,0.47683414344782954,0.3645320197044335,0
11,55,605,120,109,0.9362790538862973,0.19510619443598798,0.2,0
15,72,1080,128,113,0.6766175203318663,0.5737980765260797,0.20833333333333334,0
0,0,0,0,0,0.0,0.0,0.0,0
14,79,1106,103,89,0.6642977294551057,0.54387652219663,0.17721518987341772,0
41,894,36654,114,73,0.6961636715892062,0.5562148733970983,0.04586129753914989,0
33,412,13596,113,80,0.936004472479147,0.9550886599799454,0.08009708737864078,0
10,63,630,121,111,0.8043030922238579,0.5365181726510808,0.15873015873015872,0
37,280,10360,122,85,0.7544361328343772,0.5399948367097341,0.13214285714285715,0
25,170,4250,105,80,0.797302266283796,0.8278217303409532,0.14705882352941177,0
42,481,20202,120,78,0.7048525305699105,0.4139509034447359,0.08731808731808732,0
33,571,18843,113,80,0.7708485703274138,0.5579033792742789,0.05779334500875657,0
22,64,1408,94,72,0.6443435145122198,0.2947531723732828,0.34375,0
31,101,3131,101,70,0.6285930027047183,0.29307984322145003,0.3069306930693069,0
32,142,4544,74,42,0.543233811987422,0.32953427317030715,0.22535211267605634,0
23,161,3703,119,96,0.6193199800381337,0.2406802508845553,0.14285714285714285,0
11,68,748,126,115,0.7183814446800711,0.6216173941531445,0.16176470588235295,0
18,64,1152,104,86,0.7590557187373005,0.45192685660460097,0.28125,0
22,141,3102,105,83,0.5924428989593618,0.3623849125220912,0.15602836879432624,0
13,56,728,128,115,0.7063027238683792,0.5065195757655662,0.23214285714285715,0
14,60,840,129,115,0.6811698656099875,0.4555148436141342,0.23333333333333334,0
70,162,11340,102,32,0.525756396050818,0.22989917332628262,0.43209876543209874,0
24,102,2448,104,80,0.6305856406928857,0.4201048253601831,0.23529411764705882,0
12,78,936,127,115,0.7833167511248126,0.5823920980268428,0.15384615384615385,0
15,73,1095,132,117,0.6402378286687348,0.5755628508862735,0.2054794520547945,0
15,80,1200,130,115,0.7898741434211101,0.5910370178907541,0.1875,0
24,107,2568,104,80,0.687319778724437,0.5744884833058774,0.22429906542056074,0
12,58,696,121,109,0.8337598157674084,0.44582126044065085,0.20689655172413793,0
76,471,35796,106,30,0.6210272013100032,0.4572536741908343,0.1613588110403397,0
21,67,1407,130,109,0.7626196054089657,0.6310769416801932,0.31343283582089554,0
18,92,1656,131,113,0.6245616818845878,0.5173499568978276,0.1956521739130435,0
22,98,2156,131,109,0.8018058511046581,0.6279724168736319,0.22448979591836735,0
13,49,637,128,115,0.5989780803838335,0.3875703280783532,0.2653061224489796,0
10,70,700,129,119,0.8099359995369545,0.8690715703712865,0.14285714285714285,0
17,117,1989,128,111,0.7660736407937857,0.6270963210389213,0.1452991452991453,0
14,52,728,130,116,0.6948666032408146,0.7065003486949274,0.2692307692307692,0
12,66,792,126,114,0.9022614982890667,0.7497685172994171,0.18181818181818182,0
16,63,1008,132,116,0.6623356841111709,0.5980185774831484,0.25396825396825395,0
16,59,944,130,114,0.7109669666596046,0.5090544004780084,0.2711864406779661,0
11,67,737,126,115,0.7698331655930194,0.8148197476799641,0.16417910447761194,0
10,70,700,124,114,0.6717693476772485,0.4682189688471965,0.14285714285714285,0
12,64,768,121,109,0.8890798931037672,0.4274547410336863,0.1875,0
12,76,912,125,113,0.8346513677305492,0.5906854638504221,0.15789473684210525,0
27,97,2619,104,77,0.8368254021690562,0.6389088214606087,0.27835051546391754,0
15,99,1485,129,114,0.6955717223539967,0.61324448253512,0.15151515151515152,0
12,69,828,127,115,0.8892088626232434,0.8727302166695495,0.17391304347826086,0
12,59,708,127,115,0.9063524170886219,0.5873689710987179,0.2033898305084746,0
13,90,1170,125,112,1.129322564531482,0.9235336974869168,0.14444444444444443,0
11,75,825,125,114,0.8947273069374878,0.8543911820606032,0.14666666666666667,0
13,70,910,125,112,0.9628680713858674,0.974326671290383,0.18571428571428572,0
13,70,910,125,112,0.9628680713858674,0.974326671290383,0.18571428571428572,0
87,208,18096,116,29,0.7879873450614329,0.5686615013081759,0.4182692307692308,0
14,70,980,125,111,0.7713875612773282,0.6474567415156172,0.2,0
74,157,11618,105,31,0.7288321017369518,0.397641643402518,0.4713375796178344,0
35,87,3045,121,86,0.814308450480285,0.3785901662295114,0.40229885057471265,0
14,95,1330,128,114,0.8922239167318692,0.7574256651924514,0.14736842105263157,0
16,107,1712,130,114,0.8851968548386514,0.6802402211709526,0.14953271028037382,0
16,92,1472,129,113,1.0400580783056026,0.955102743432122,0.17391304347826086,0
12,54,648,127,115,0.8721150848880478,1.055962912554758,0.2222222222222222,0
16,113,1808,129,113,0.9718123820405061,0.8569523358263836,0.1415929203539823,0
13,81,1053,127,114,0.8556802731997603,0.8665126233734279,0.16049382716049382,0
15,97,1455,127,112,0.8483088069871314,0.6618904572513495,0.15463917525773196,0
13,50,650,129,116,0.7065532541127928,0.6206018384798577,0.26,0
11,69,759,125,114,0.9760450036008803,0.7923618566758378,0.15942028985507245,0
13,87,1131,126,113,0.8962810643463229,0.7836080944440278,0.14942528735632185,0
16,73,1168,131,115,0.7003220583229539,0.6849963889775522,0.2191780821917808,0
14,75,1050,128,114,0.9503233681712309,0.8367675321445843,0.18666666666666668,0
14,60,840,128,114,0.7623579576720397,0.6915324883603203,0.23333333333333334,0
13,79,1027,123,110,0.9326024006354459,0.7180176897789412,0.16455696202531644,0
12,60,720,128,116,0.9302756411743899,1.0177562041738035,0.2,0
73,146,10658,104,31,0.7945140045018385,0.5446648952910678,0.5,0
14,95,1330,124,110,1.011150207664308,0.8938743345401292,0.14736842105263157,0
12,77,924,126,114,0.8955753424181265,0.8826778234123488,0.15584415584415584,0
20,95,1900,125,105,0.7487104815557188,0.5285534326778223,0.21052631578947367,0
18,124,2232,129,111,0.8006454553896069,0.6662625425634419,0.14516129032258066,0
14,74,1036,128,114,0.8860736284453018,0.7916201535004327,0.1891891891891892,0
12,66,792,126,114,0.8536462458992171,0.7541858036776187,0.18181818181818182,0
15,80,1200,128,113,0.8623931783862036,0.7991302249737877,0.1875,0
35,71,2485,103,68,0.7000183332185804,0.43305189869203764,0.49295774647887325,1
23,68,1564,164,141,0.9546862525106257,0.3660844050891876,0.3382352941176471,1
15,70,1050,130,115,0.8258395076396268,0.8575197930914062,0.21428571428571427,0
13,56,728,125,112,0.8035719299719893,0.7652605299157489,0.23214285714285715,0
22,44,968,112,90,0.6537989990500841,0.4411531259990064,0.5,0
10,64,640,127,117,0.7852914211322364,0.6484270826899422,0.15625,0
35,37,1295,121,86,1.2290742177072447,0.0,0.9459459459459459,0
11,62,682,127,116,0.7802315411428169,0.7864433059444685,0.1774193548387097,0
21,84,1764,132,111,0.8231511511174144,0.7822482694029101,0.25,0
10,65,650,124,114,0.7613778432493499,0.7206983333690284,0.15384615384615385,0
25,34,850,133,108,0.5280306693134608,0.3287864318818732,0.7352941176470589,0
21,92,1932,107,86,0.46526954941884235,0.13983165954350021,0.22826086956521738,0
16,49,784,106,90,0.537849698771463,0.258783485549124,0.32653061224489793,0
31,143,4433,109,78,0.5333258214786544,0.20593635028363674,0.21678321678321677,0
23,159,3657,129,106,0.7173958392279517,0.6546092036149123,0.14465408805031446,0
17,96,1632,149,132,0.6509485960730721,0.13502896621103994,0.17708333333333334,0
16,105,1680,105,89,0.6045567293152938,0.5227402210157894,0.1523809523809524,0
19,49,931,119,100,0.5497226838811035,0.24311735433784673,0.3877551020408163,0
18,48,864,105,87,0.5643620506023476,0.25464588751065,0.375,0
28,80,2240,114,86,0.5614805658313974,0.2140916484666527,0.35,0
32,217,6944,129,97,0.5662722139865282,0.4358005881690699,0.14746543778801843,0
11,57,627,126,115,0.6315872531182515,0.6210368420709943,0.19298245614035087,0
12,57,684,127,115,0.5968619141192748,0.5818339928724542,0.21052631578947367,0
27,107,2889,116,89,0.6552231591404436,0.364306691908576,0.2523364485981308,0
11,66,726,128,117,0.6779651807861977,0.6328992524956507,0.16666666666666666,0
25,77,1925,105,80,0.5505919603925085,0.23638780994087752,0.3246753246753247,0
14,60,840,135,121,0.7034144378393867,0.19092685849491303,0.23333333333333334,0
16,41,656,111,95,0.617128559695993,0.3054272621338029,0.3902439024390244,0
34,148,5032,114,80,0.6769781011067899,0.34629338400861864,0.22972972972972974,0
24,130,3120,101,77,0.5824502293484831,0.322510408272977,0.18461538461538463,0
12,62,744,123,111,0.6259665993523558,0.4301178795918559,0.1935483870967742,0
32,155,4960,104,72,0.6578572968375871,0.49676888659980095,0.2064516129032258,0
18,51,918,149,131,0.7248065562295344,0.0,0.35294117647058826,0
12,53,636,128,116,0.6837146382000031,0.5531391654817747,0.22641509433962265,0
34,581,19754,103,69,0.5896919852678002,0.29713260319619383,0.058519793459552494,0
53,142,7526,124,71,0.614506569193346,0.36657982928079125,0.3732394366197183,0
13,61,793,128,115,0.729614530313354,0.8207661788493175,0.21311475409836064,0
31,100,3100,102,71,0.6200882316068242,0.4555867682705415,0.31,0
17,55,935,115,98,0.6752962353040102,0.18369217109029287,0.3090909090909091,0
20,121,2420,102,82,0.5776896634961176,0.3060130741788421,0.1652892561983471,0
83,237,19671,113,30,0.6648754243185927,0.4261766015893003,0.350210970464135,0
12,53,636,123,111,0.7876484081968566,0.4222559316492419,0.22641509433962265,0
18,84,1512,126,108,0.766165198074207,0.4868157378750599,0.21428571428571427,0
13,80,1040,122,109,0.5897726988009999,0.34787624377469745,0.1625,0
11,73,803,129,118,0.7557709187622798,0.6767702366691445,0.1506849315068493,0
19,82,1558,116,97,0.7797036542650149,0.17046495793119162,0.23170731707317074,0
25,127,3175,116,91,0.6522147637803679,0.1374030913346083,0.1968503937007874,0
12,70,840,130,118,0.6329471735272635,0.4239737144445338,0.17142857142857143,0
36,160,5760,123,87,0.47367953034487287,0.008304834363902844,0.225,0
29,102,2958,115,86,0.5758791611827224,0.23919137671443752,0.28431372549019607,0
14,76,1064,126,112,0.7521011756368298,0.642095788478073,0.18421052631578946,0
71,142,10082,102,31,0.749911072486818,0.5437620154424387,0.5,0
93,196,18228,124,31,0.5527113208616848,0.20884196210251166,0.4744897959183674,0
37,48,1776,124,87,0.9179021473868547,0.28087152960284506,0.7708333333333334,0
16,63,1008,114,98,1.1487892624127611,0.1817762775829523,0.25396825396825395,0
11,55,605,127,116,0.8647078821260695,0.8160396981751795,0.2,0
11,64,704,127,116,0.7496402470487454,0.6758677963547951,0.171875,0
30,126,3780,103,73,0.8289838309348244,0.5639867991726093,0.23809523809523808,0
32,92,2944,121,89,0.9263675827162837,0.17924521654915923,0.34782608695652173,0
27,85,2295,116,89,0.9588215836561055,0.32014256071926345,0.3176470588235294,0
12,56,672,118,106,0.9100769616082212,0.35759447487908036,0.21428571428571427,0
13,50,650,123,110,0.659914344574397,0.31371773201934766,0.26,0
10,65,650,101,91,0.5955929861596712,0.2300623134811093,0.15384615384615385,0
15,62,930,102,87,0.5599412471767121,0.22307556523166167,0.24193548387096775,0
16,105,1680,101,85,0.6053111641980246,0.34869371987147213,0.1523809523809524,0
12,54,648,122,110,0.546647848909969,0.3053251213848155,0.2222222222222222,0
32,78,2496,106,74,0.5401161707572274,0.2446018682352815,0.41025641025641024,0
12,55,660,97,85,0.5650214105777376,0.38779340698795434,0.21818181818181817,0
17,62,1054,103,86,0.6126169764742936,0.3428650677237935,0.27419354838709675,0
16,57,912,103,87,0.6083988710041581,0.35330596157663163,0.2807017543859649,0
11,59,649,102,91,0.5872215307902406,0.28390112143928603,0.1864406779661017,0
20,95,1900,119,99,0.6052458724397112,0.13789635034237102,0.21052631578947367,0
17,68,1156,126,109,0.5971850418466691,0.21183224133358666,0.25,0
14,75,1050,125,111,0.5339725891001902,0.3089178692090335,0.18666666666666668,0
26,79,2054,112,86,0.5897970887158098,0.31950103057652657,0.3291139240506329,0
31,222,6882,128,97,0.5366779774365252,0.32734989547133647,0.13963963963963963,0
12,53,636,122,110,0.6769295242972905,0.42422988070151446,0.22641509433962265,0
20,94,1880,121,101,0.5635309755011403,0.04854803965249888,0.2127659574468085,0
12,79,948,130,118,0.5647383760686583,0.508772267288451,0.1518987341772152,0
35,60,2100,118,83,0.5932402947650729,0.02045488213529247,0.5833333333333334,0
16,53,848,102,86,0.7029890416393466,0.4500318695076001,0.3018867924528302,0
73,188,13724,103,30,0.5839518123720792,0.40246743105991956,0.3882978723404255,0
16,93,1488,103,87,0.7068160003398068,0.5110964029977189,0.17204301075268819,0
23,106,2438,113,90,0.5468230740444053,0.318224442762576,0.2169811320754717,0
16,95,1520,103,87,0.6282100950176045,0.40608241934290285,0.16842105263157894,0
25,139,3475,98,73,0.6276464599439171,0.4056098043514017,0.17985611510791366,0
30,140,4200,109,79,0.6453346424507261,0.4288243546865919,0.21428571428571427,0
28,159,4452,104,76,0.8283776437014678,0.19901614532669915,0.1761006289308176,0
16,104,1664,116,100,0.7965326922651119,0.23561078411173517,0.15384615384615385,0
15,61,915,177,162,0.7175844725009799,0.09633859412792951,0.2459016393442623,0
23,149,3427,100,77,0.5519607698705681,0.292388311276956,0.15436241610738255,0
15,51,765,125,110,0.6670194973401541,0.6310911161901426,0.29411764705882354,0
14,57,798,120,106,0.8008488798748018,0.0,0.24561403508771928,0
10,67,670,128,118,0.6284503412709058,0.611891846587305,0.14925373134328357,0
28,55,1540,126,98,0.668537074976676,0.1382422155499209,0.509090909090909,0
14,82,1148,130,116,0.6367443041470393,0.343035703049223,0.17073170731707318,0
12,82,984,101,89,0.7880943134321703,0.6331242144282153,0.14634146341463414,0
70,66,4620,101,31,0.6582960432166289,0.4258069123934207,1.0606060606060606,0
12,58,696,164,152,0.9545406689954442,0.1514754276585023,0.20689655172413793,0
24,97,2328,96,72,0.6987700987284743,0.6040481151200096,0.24742268041237114,0
15,67,1005,100,85,0.618793458479757,0.23197785398167828,0.22388059701492538,0
69,51,3519,101,32,0.6219382871040384,0.3391823203117398,1.3529411764705883,0
13,89,1157,129,116,0.6773607689164332,0.6265195978401265,0.14606741573033707,0
69,182,12558,100,31,0.8528490728921702,0.6909455054988164,0.3791208791208791,0
16,81,1296,102,86,0.8420541226568232,0.6902736421336599,0.19753086419753085,0
12,64,768,128,116,0.7373599865514395,0.6708212176457858,0.1875,0
18,74,1332,115,97,0.9920777333772333,0.07279365330890884,0.24324324324324326,0
65,61,3965,98,33,0.6182591689339115,0.22853850272604956,1.0655737704918034,0
12,81,972,127,115,0.6967694221191154,0.7742664151565162,0.14814814814814814,0
67,178,11926,100,33,0.6760112856087312,0.43492814950284403,0.37640449438202245,0
16,97,1552,103,87,0.7460313676639181,0.7242536771107552,0.16494845360824742,0
34,99,3366,121,87,0.7016454956039547,0.3827424735885517,0.3434343434343434,0
11,76,836,125,114,0.8463340148169928,0.6553268774677984,0.14473684210526316,0
13,64,832,127,114,0.6970500490135382,0.5410606966742164,0.203125,0
71,211,14981,102,31,0.671093507482278,0.5114575072420922,0.33649289099526064,0
12,81,972,128,116,0.890852921195511,0.8421731815185844,0.14814814814814814,0
71,186,13206,102,31,0.7110625865586989,0.5114458759337179,0.3817204301075269,0
14,66,924,105,91,0.6867825337157597,0.3687296844876934,0.21212121212121213,0
15,80,1200,105,90,0.813489698512992,0.6264203196278345,0.1875,0
68,120,8160,100,32,0.6120307002649427,0.5069089813519239,0.5666666666666667,0
13,48,624,99,86,0.6351843967293002,0.4910090443630104,0.2708333333333333,0
22,97,2134,99,77,0.5913436173210682,0.47797884379897837,0.2268041237113402,0
11,60,660,129,118,0.7116927421847424,0.49587631718754815,0.18333333333333332,0
69,139,9591,100,31,0.675117723752849,0.49469397227064726,0.49640287769784175,0
33,134,4422,121,88,0.6330276540463714,0.2534588372392035,0.2462686567164179,0
12,79,948,107,95,0.5014467034700304,0.11643833761815224,0.1518987341772152,0
24,106,2544,97,73,0.7748949797276292,0.4487311242040006,0.22641509433962265,0
81,205,16605,111,30,0.6756685478084218,0.4767207507231118,0.3951219512195122,0
20,49,980,98,78,0.7561619075017633,0.44354428343860297,0.40816326530612246,0
74,209,15466,104,30,1.434734854413709,1.4480536032874947,0.35406698564593303,0
65,76,4940,96,31,0.7423128924174008,0.5157002523964358,0.8552631578947368,0
14,63,882,99,85,0.9074773651202489,0.4843914820106334,0.2222222222222222,0
70,116,8120,101,31,0.8063156092588133,0.5914275893314718,0.603448275862069,0
12,56,672,100,88,0.7988325259135264,0.6986125695840976,0.21428571428571427,0
18,71,1278,128,110,0.7056482970536966,0.6284165056701762,0.2535211267605634,0
70,237,16590,101,31,0.637308508961212,0.46456623978916445,0.29535864978902954,0
16,92,1472,101,85,0.6875455412950763,0.4505723063590925,0.17391304347826086,0
15,69,1035,130,115,0.8017417919588817,0.8026701577664798,0.21739130434782608,0
18,85,1530,128,110,0.5936614020398779,0.5215840329570554,0.21176470588235294,0
14,46,644,120,106,0.7109720316593391,0.20940758286366434,0.30434782608695654,0
12,80,960,125,113,0.8555128484019726,0.7803473247055998,0.15,0
30,138,4140,103,73,0.6965864341809233,0.5202427164779739,0.21739130434782608,0
13,60,780,129,116,0.733598052124184,0.5671574071161621,0.21666666666666667,0
42,50,2100,104,62,0.610936955022343,0.46313920194717717,0.84,0
19,117,2223,131,112,0.8568569163702299,0.8519282235671483,0.1623931623931624,0
21,44,924,101,80,0.6477980280477816,0.3252847090970157,0.4772727272727273,0
13,49,637,122,109,0.6441588555645711,0.2939554712610653,0.2653061224489796,0
15,79,1185,132,117,0.7202285504252759,0.5339181304124898,0.189873417721519,0
12,63,756,128,116,0.753024449157216,0.6709733160064706,0.19047619047619047,0
14,53,742,95,81,0.6965863072248303,0.4752706432311027,0.2641509433962264,0
86,133,11438,150,64,0.7099570665790964,0.2992528362798268,0.6466165413533834,0
48,661,31728,79,31,0.7600254191905614,0.6337055903678732,0.07261724659606657,0
21,43,903,165,144,0.5542907620483283,0.039817270901462205,0.4883720930232558,0
12,61,732,130,118,0.6389933857229179,0.4196534361777455,0.19672131147540983,0
18,128,2304,131,113,0.6017046757547144,0.5473490173675912,0.140625,0
18,95,1710,96,78,0.5938339138524601,0.4390316720965681,0.18947368421052632,0
14,77,1078,113,99,0.5852830993286994,0.1893215198159294,0.18181818181818182,0
13,76,988,132,119,0.507326667894745,0.33638081380261103,0.17105263157894737,0
35,98,3430,120,85,0.4568576043101357,0.2160964799499965,0.35714285714285715,0
23,48,1104,114,91,0.5563755319571632,0.0,0.4791666666666667,0
16,45,720,120,104,0.5577346256614069,0.012885330225683618,0.35555555555555557,0
16,68,1088,100,84,0.5063006806049237,0.2087835653351669,0.23529411764705882,0
33,211,6963,131,98,0.6492993970005656,0.1890799269926568,0.15639810426540285,0
18,54,972,104,86,0.5401766819832361,0.3224135156424841,0.3333333333333333,0
0,0,0,0,0,0.0,0.0,0.0,0
21,52,1092,108,87,0.4903180210493563,0.13311431586182199,0.40384615384615385,0
60,168,10080,120,60,0.6296467529281017,0.1409315781668422,0.35714285714285715,0
87,132,11484,117,30,0.6976104325188395,0.5425354964728066,0.6590909090909091,0
74,218,16132,104,30,0.5852506563369969,0.37809840698247044,0.3394495412844037,0
18,99,1782,131,113,0.5807291441855917,0.5083947602531953,0.18181818181818182,0
59,434,25606,131,72,0.5613707778865594,0.4426552814768373,0.1359447004608295,0
22,149,3278,131,109,0.6784531408082333,0.6858484980104312,0.1476510067114094,0
13,85,1105,124,111,0.6195979864734616,0.5998273022033321,0.15294117647058825,0
31,786,24366,130,99,0.9061143469232115,0.937455326043967,0.039440203562340966,0
72,273,19656,102,30,0.7680340283972764,0.6717017263899492,0.26373626373626374,0
14,71,994,101,87,0.7356000659853915,0.5261923491048204,0.19718309859154928,0
18,128,2304,129,111,0.6140789315503927,0.5576184537589499,0.140625,0
11,76,836,121,110,0.8278237100410722,0.5175929387946937,0.14473684210526316,0
15,82,1230,101,86,0.751829627763797,0.5385461775567167,0.18292682926829268,0
12,54,648,123,111,0.7586391138879974,0.5051682137698491,0.2222222222222222,0
44,248,10912,131,87,0.7085820066599767,0.5792562314504259,0.1774193548387097,0
70,188,13160,101,31,0.9452960142613338,0.837265608787696,0.3723404255319149,0
72,139,10008,102,30,0.7431398191945712,0.5807681985068831,0.5179856115107914,0
72,165,11880,102,30,0.9354555797289098,0.7895698685469692,0.43636363636363634,0
72,87,6264,102,30,0.8012839691973621,0.6446778954881882,0.8275862068965517,0
14,71,994,124,110,0.7424415852286268,0.5387394556909196,0.19718309859154928,0
76,78,5928,106,30,0.6416718409464257,0.49101433926725596,0.9743589743589743,0
73,203,14819,103,30,0.7160528012100846,0.5709860949703035,0.35960591133004927,0
69,275,18975,100,31,0.6823443498222937,0.5740268236434525,0.2509090909090909,0
35,275,9625,100,65,0.5183284965999586,0.2168689402508395,0.12727272727272726,0
36,178,6408,104,68,0.5309663874636945,0.2049008498661674,0.20224719101123595,0
42,322,13524,111,69,0.5603375266580027,0.38366255977913705,0.13043478260869565,0
22,55,1210,120,98,0.7223654132496306,0.07858365474649091,0.4,0
41,260,10660,111,70,0.5500377555997266,0.34493680726790027,0.1576923076923077,0
19,62,1178,120,101,0.7124642543089698,0.2236343234737059,0.3064516129032258,0
17,74,1258,127,110,0.5776357189096152,0.42972354675459024,0.22972972972972974,0
80,179,14320,111,31,0.5138540731694755,0.2565475939048064,0.44692737430167595,0
13,67,871,121,108,0.7370515816110258,0.36358009081678694,0.19402985074626866,0
34,373,12682,103,69,0.4980539194893764,0.20870722965918245,0.09115281501340483,0
123,316,38868,187,64,1.4181697413959735,0.9793736385734239,0.38924050632911394,1
17,37,629,158,141,0.4489398196070283,0.0,0.4594594594594595,0
43,764,32852,101,58,0.4894699152338631,0.2881581593617152,0.056282722513089,0
10,61,610,95,85,0.5362071724630816,0.26030002235702027,0.16393442622950818,0
36,335,12060,104,68,0.6152169658083597,0.419252595402517,0.10746268656716418,0
13,63,819,91,78,0.5217929486847933,0.3077397280784176,0.20634920634920634,0
45,388,17460,76,31,0.5477270094090558,0.26514771762188005,0.11597938144329897,0
54,134,7236,108,54,0.6470158331785275,0.3262472735341605,0.40298507462686567,0
25,62,1550,127,102,0.6235466865012963,0.28299853629559474,0.4032258064516129,0
64,127,8128,133,69,0.4947023794330842,0.19606322392904313,0.5039370078740157,0
23,43,989,109,86,0.5173296719420285,0.22320653155145012,0.5348837209302325,0
31,101,3131,117,86,0.8147508402815308,0.18958574839762288,0.3069306930693069,0
13,92,1196,186,173,0.6171759460301152,0.12042714838942781,0.14130434782608695,0
20,91,1820,109,89,0.5025853350034266,0.1460081479325423,0.21978021978021978,0
46,280,12880,120,74,0.4443487223589689,0.051214034548511506,0.16428571428571428,0
83,369,30627,113,30,0.4577084282008238,0.0778355532401762,0.22493224932249323,0
15,93,1395,65,50,0.5087951629608887,0.3439833495417534,0.16129032258064516,0
13,62,806,125,112,0.5360795786295843,0.24333308346706464,0.20967741935483872,0
16,58,928,48,32,0.5101231172652096,0.3393231201851488,0.27586206896551724,0
15,85,1275,101,86,0.5756359290873871,0.4250009417407414,0.17647058823529413,0
10,63,630,132,122,0.5340198352364299,0.43312799938909696,0.15873015873015872,0
38,87,3306,110,72,0.45283473857945017,0.14439482861929276,0.4367816091954023,0
17,119,2023,103,86,0.4785890346764082,0.11217589035592163,0.14285714285714285,0
60,85,5100,118,58,0.5213144365157761,0.24564678561808836,0.7058823529411765,0
22,72,1584,122,100,0.5973059489801982,0.257179754978377,0.3055555555555556,0
29,68,1972,131,102,0.4872952869917837,0.28379738918994635,0.4264705882352941,0
11,58,638,100,89,0.7547285095820341,0.5646379846937208,0.1896551724137931,0
28,90,2520,113,85,0.6319081069602928,0.4633716141179902,0.3111111111111111,0
14,85,1190,131,117,0.531049056774959,0.26110885638527576,0.16470588235294117,0
13,56,728,132,119,0.5653898289236994,0.42726296750963394,0.23214285714285715,0
14,52,728,134,120,0.60256926014505,0.2389576864252165,0.2692307692307692,0
12,75,900,135,123,0.7081961001654705,0.4516302908608056,0.16,0
18,59,1062,129,111,0.5449862805915872,0.39211799749146586,0.3050847457627119,0
10,64,640,128,118,0.6591885628984342,0.4550192905474771,0.15625,0
20,103,2060,131,111,0.5500212561098525,0.40920242690044695,0.1941747572815534,0
12,53,636,124,112,0.5433822978115843,0.30025405369568187,0.22641509433962265,0
28,133,3724,100,72,0.5779112239573573,0.32042267762705723,0.21052631578947367,0
20,71,1420,103,83,0.6368595295338707,0.28892272292581644,0.28169014084507044,0
14,96,1344,132,118,0.6225648221643646,0.43547940391626416,0.14583333333333334,0
16,67,1072,132,116,0.5642455667293974,0.3160238482618625,0.23880597014925373,0
44,101,4444,101,57,0.5311010290862461,0.24507894722435164,0.43564356435643564,0
20,72,1440,131,111,0.5710339080084206,0.32995437849475173,0.2777777777777778,0
12,53,636,122,110,0.7033947991524632,0.20466658152595443,0.22641509433962265,0
14,99,1386,101,87,0.6437692140806949,0.11069596272715668,0.1414141414141414,0
12,73,876,130,118,0.7578948095469675,0.7293432378898935,0.1643835616438356,0
10,70,700,130,120,0.6475654670885412,0.6466402673132574,0.14285714285714285,0
24,119,2856,121,97,0.5819478452198603,0.1072283137939558,0.20168067226890757,0
23,86,1978,125,102,0.6384958494209737,0.3132638413659086,0.26744186046511625,0
16,40,640,132,116,0.5836211510115912,0.503559469844365,0.4,0
15,91,1365,127,112,0.643475348031002,0.2662678393720338,0.16483516483516483,0
11,72,792,132,121,0.6709508031065187,0.6037136537608951,0.1527777777777778,0
13,59,767,130,117,0.5589101195074017,0.5607289972161221,0.22033898305084745,0
34,126,4284,121,87,0.8829146249563592,0.2674773367384013,0.2698412698412698,0
20,119,2380,131,111,0.5571857474743466,0.3480198065708742,0.16806722689075632,0
15,41,615,133,118,0.6619035301902552,0.6295084447172886,0.36585365853658536,0
20,121,2420,105,85,0.6712742890772733,0.47589042071105386,0.1652892561983471,0
17,66,1122,102,85,0.8094052648579055,0.5633257684529339,0.25757575757575757,0
14,79,1106,125,111,0.6352273531006741,0.20969088025083077,0.17721518987341772,0
70,280,19600,102,32,0.6485693843770056,0.5440969748494411,0.25,0
19,99,1881,133,114,0.8239686077602728,0.75900927830445,0.1919191919191919,0
21,114,2394,131,110,0.6008991353656647,0.4076868912497741,0.18421052631578946,0
13,78,1014,129,116,0.7966688570218191,0.6419440794416084,0.16666666666666666,0
11,72,792,120,109,0.7899461027994752,0.1499642455236533,0.1527777777777778,0
24,102,2448,136,112,0.6866879113173472,0.2982700934083058,0.23529411764705882,0
16,107,1712,132,116,0.6055853790541533,0.40507829659731304,0.14953271028037382,0
44,251,11044,129,85,0.6561806887794767,0.47320129553829693,0.1752988047808765,0
25,145,3625,134,109,0.6185618283636217,0.5313471165533273,0.1724137931034483,0
21,94,1974,131,110,0.5983470012404569,0.45451302147993494,0.22340425531914893,0
14,75,1050,124,110,0.779997862277632,0.35167913615599267,0.18666666666666668,0
13,61,793,131,118,0.7227355931745219,0.6914856439381996,0.21311475409836064,0
12,59,708,128,116,0.6852794610709511,0.6821199976110848,0.2033898305084746,0
15,66,990,131,116,0.7398150831083545,0.589554991173821,0.22727272727272727,0
11,68,748,128,117,0.8082469083911584,0.8465479619377515,0.16176470588235295,0
19,92,1748,130,111,0.7272919892512227,0.5329796698744493,0.20652173913043478,0
70,190,13300,102,32,0.6890585777515131,0.4744675826253131,0.3684210526315789,0
16,91,1456,132,116,0.6354642038292618,0.5408345439445491,0.17582417582417584,0
14,63,882,128,114,0.7788722870332017,0.8312897287824993,0.2222222222222222,0
20,82,1640,132,112,0.5560832430137517,0.27433853143784653,0.24390243902439024,0
20,74,1480,100,80,0.6860614548248746,0.5893596149104472,0.2702702702702703,0
30,184,5520,115,85,0.6402681556436235,0.3245595444053561,0.16304347826086957,0
70,157,10990,102,32,0.7080931067337614,0.5332532143222466,0.445859872611465,0
11,57,627,127,116,0.7462167088061029,0.6919370869732997,0.19298245614035087,0
12,63,756,130,118,0.6999086053887761,0.24541024098243885,0.19047619047619047,0
44,148,6512,130,86,0.44408232232036504,0.16491757744263782,0.2972972972972973,0
72,147,10584,102,30,0.6757885359560566,0.48285234283631806,0.4897959183673469,0
11,64,704,126,115,0.7191854027483239,0.7516824338592069,0.171875,0
18,66,1188,128,110,0.6440923468958537,0.2743950783121589,0.2727272727272727,0
14,66,924,131,117,0.7143196594536749,0.5288118669658793,0.21212121212121213,0
29,89,2581,108,79,0.5724283012222415,0.21195965207373513,0.3258426966292135,0
13,92,1196,131,118,0.6019300130621335,0.38389441493204524,0.14130434782608695,0
16,98,1568,114,98,0.6408967053143032,0.14210223954894335,0.16326530612244897,0
70,186,13020,102,32,0.5263584270625513,0.2909070992784765,0.3763440860215054,0
11,78,858,120,109,0.7728711112273725,0.10971084204980534,0.14102564102564102,0
17,95,1615,101,84,0.5891798646063358,0.3113557166062176,0.17894736842105263,0
31,184,5704,107,76,0.5227805230079272,0.28635319375243884,0.16847826086956522,0
23,93,2139,101,78,0.4586534057507035,0.23172212300020878,0.24731182795698925,0
56,107,5992,142,86,0.49410425347457837,0.3142685350580569,0.5233644859813084,0
19,73,1387,129,110,0.5090174977425398,0.38803135993333604,0.2602739726027397,0
20,119,2380,107,87,0.5550461624452729,0.3225466034168917,0.16806722689075632,0
24,130,3120,106,82,0.6909938419458201,0.31937297439161055,0.18461538461538463,0
13,67,871,132,119,0.5116257087878311,0.2458573635947218,0.19402985074626866,0
34,161,5474,100,66,0.43844785063159314,0.12305419537516345,0.2111801242236025,0
31,306,9486,108,77,0.4611299598871358,0.19779688214793095,0.10130718954248366,0
11,78,858,150,139,1.0165680378228348,0.15968576140590868,0.14102564102564102,0
17,60,1020,121,104,0.755844816435475,0.14785520333922741,0.2833333333333333,0
15,60,900,125,110,0.6288091039196332,0.4759360152970523,0.25,0
18,69,1242,103,85,0.6701221380180458,0.30166369468232035,0.2608695652173913,0
10,63,630,133,123,0.5028046671799136,0.5312383690297109,0.15873015873015872,0
11,64,704,99,88,0.5961473101350885,0.40430256508514256,0.171875,0
17,92,1564,103,86,0.5447992183451597,0.0737625194584579,0.18478260869565216,0
18,76,1368,123,105,0.8803931936688025,0.3554152413708544,0.23684210526315788,0
19,50,950,131,112,0.5685843303188189,0.4023933787656031,0.38,0
10,61,610,120,110,0.7890370207770686,0.2567882617495674,0.16393442622950818,0
12,60,720,131,119,0.5833810829361069,0.4954287480799809,0.2,0
17,92,1564,115,98,0.8000188759846083,0.14221306392046612,0.18478260869565216,0
37,247,9139,114,77,0.4952463467993715,0.04267895997763361,0.14979757085020243,0
23,70,1610,182,159,0.557666675355432,0.330728412446571,0.32857142857142857,0
26,103,2678,185,159,0.6299553274406562,0.29331867533163897,0.2524271844660194,0
26,185,4810,56,30,0.6287703215705024,0.426521124343809,0.14054054054054055,0
15,75,1125,55,40,0.4954430917043194,0.16143533091634077,0.2,0
23,76,1748,172,149,0.4282529326818196,0.0,0.3026315789473684,0
16,39,624,94,78,0.5436019223194499,0.281146939246438,0.41025641025641024,0
0,0,0,0,0,0.0,0.0,0.0,0
23,36,828,174,151,0.44988804788027514,0.0,0.6388888888888888,0
15,54,810,126,111,0.6062060358073963,0.019117511935768362,0.2777777777777778,0
12,76,912,54,42,0.5099970072413639,0.37659314231644764,0.15789473684210525,0
11,62,682,177,166,0.8057803737594399,0.01895286934166869,0.1774193548387097,0
0,0,0,0,0,0.0,0.0,0.0,0
10,61,610,183,173,1.380279892225973,0.6881613214501596,0.16393442622950818,0
18,93,1674,50,32,0.7405057798834079,0.433228402189374,0.1935483870967742,0
11,61,671,44,33,0.7628474559807293,0.3512400663678935,0.18032786885245902,0
16,60,960,49,33,0.7175791613878353,0.377854000614203,0.26666666666666666,0
11,55,605,128,117,0.7254377403742757,0.0,0.2,0
0,0,0,0,0,0.0,0.0,0.0,0
12,62,744,57,45,0.5527802910629116,0.2866286890756293,0.1935483870967742,0
13,58,754,132,119,0.44084232360169995,0.0,0.22413793103448276,0
14,71,994,124,110,0.8093944381171049,0.3313696664916418,0.19718309859154928,0
25,60,1500,55,30,0.6196651202137291,0.27493240353164616,0.4166666666666667,0
14,59,826,154,140,0.7860282166673297,0.01433312263042755,0.23728813559322035,0
10,65,650,52,42,0.5816749834557443,0.3539295738548896,0.15384615384615385,0
13,64,832,123,110,0.7063828568266404,0.3290761431882538,0.203125,0
13,49,637,125,112,0.5679815660411659,0.191421166883338,0.2653061224489796,0
14,55,770,47,33,0.6745542369665316,0.427999738521619,0.2545454545454545,0
11,66,726,46,35,0.6204758191134141,0.23127829305330344,0.16666666666666666,0
14,47,658,156,142,0.7757898800964386,0.0,0.2978723404255319,0
11,65,715,48,37,0.6157957847596016,0.12751534261266817,0.16923076923076924,0
11,74,814,122,111,0.7814550050034482,0.33956257262477624,0.14864864864864866,0
12,66,792,121,109,1.0519205236477378,0.34772180557531496,0.18181818181818182,0
0,0,0,0,0,0.0,0.0,0.0,0
12,57,684,75,63,0.5461692773548571,0.04538305158262715,0.21052631578947367,0
14,58,812,187,173,0.5775230210034508,0.0,0.2413793103448276,0
29,112,3248,66,37,0.5024063268585682,0.0730628293361018,0.25892857142857145,0
34,37,1258,176,142,0.489000354355292,0.2882577041954438,0.918918918918919,0
13,52,676,154,141,0.44944478990816217,0.060169621938111185,0.25,0
13,87,1131,56,43,0.5012403187203136,0.2855624119251023,0.14942528735632185,0
0,0,0,0,0,0.0,0.0,0.0,0
24,91,2184,66,42,0.4943240092834149,0.23863024681595846,0.26373626373626374,0
12,58,696,187,175,0.6612165458339003,0.03048830373562267,0.20689655172413793,0
34,756,25704,69,35,0.5786654828025093,0.3361887846004827,0.04497354497354497,0
33,837,27621,65,32,0.5613189699895234,0.3219956591732957,0.03942652329749104,0
13,87,1131,76,63,0.5175915608229797,0.3065493444425669,0.14942528735632185,0
35,458,16030,69,34,0.49025450176287916,0.16000664767376527,0.07641921397379912,0
36,490,17640,69,33,0.5407001306611188,0.2949245334643752,0.07346938775510205,0
13,49,637,159,146,0.47444758440134155,0.07636187781219235,0.2653061224489796,0
36,1004,36144,69,33,0.6466688476059812,0.48355322459754896,0.035856573705179286,0
19,124,2356,139,120,0.488884903659861,0.15313725664093528,0.1532258064516129,0
0,0,0,0,0,0.0,0.0,0.0,0
24,107,2568,187,163,0.6039842748133564,0.0,0.22429906542056074,0
13,78,1014,165,152,0.7208493400010251,0.27470755284347237,0.16666666666666666,0
21,64,1344,64,43,0.5073898497779393,0.14715734835035835,0.328125,0
12,59,708,187,175,0.6873409014275509,0.02743758660821358,0.2033898305084746,0
11,60,660,55,44,0.5081469409534173,0.217416107156719,0.18333333333333332,0
21,90,1890,156,135,0.6146541312580939,0.037808758968951875,0.23333333333333334,0
18,118,2124,63,45,0.5601437837454422,0.23522566379865012,0.15254237288135594,0
11,60,660,54,43,0.5087163544659072,0.32093447592438523,0.18333333333333332,0
38,24,912,187,149,0.44416542354737104,0.0,1.5833333333333333,0
21,59,1239,124,103,0.6180351247316248,0.2145552757619538,0.3559322033898305,0
15,83,1245,126,111,0.5733298872838727,0.15771409568420774,0.18072289156626506,0
17,54,918,134,117,0.6920715630699213,0.07907010145497967,0.3148148148148148,0
22,91,2002,55,33,0.5183937519901618,0.21459216500549194,0.24175824175824176,0
20,68,1360,123,103,0.5552440534958657,0.04663944524696292,0.29411764705882354,0
26,109,2834,57,31,0.6213026258841999,0.357289177844315,0.23853211009174313,0
15,71,1065,131,116,0.7372910924851518,0.07335352436233557,0.2112676056338028,0
16,56,896,98,82,0.7108137560169787,0.5030373672346568,0.2857142857142857,0
13,88,1144,124,111,0.655411437806594,0.18489431000748435,0.14772727272727273,0
19,87,1653,55,36,0.6277489686078597,0.38861103756721727,0.21839080459770116,0
25,114,2850,56,31,0.5773264898310678,0.294176421777491,0.21929824561403508,0
13,90,1170,95,82,0.6552993576359117,0.4473662309647489,0.14444444444444443,0
13,59,767,154,141,0.7245439338298341,0.04953612522600673,0.22033898305084745,0
11,70,770,86,75,0.6682442712170323,0.41799797146254214,0.15714285714285714,0
19,71,1349,128,109,0.6783467496108823,0.20082595808694825,0.2676056338028169,0
31,119,3689,69,38,0.6284248265332049,0.25147565758509544,0.2605042016806723,0
20,96,1920,52,32,0.6539654479363985,0.4365484931797931,0.20833333333333334,0
18,67,1206,129,111,0.5047049972749179,0.05680255401766805,0.26865671641791045,0
21,78,1638,54,33,0.6385466475122321,0.1777229334828494,0.2692307692307692,0
14,75,1050,155,141,0.6273412783891376,0.1811693110374226,0.18666666666666668,0
11,71,781,56,45,0.6537307454292987,0.38979858287869146,0.15492957746478872,0
12,73,876,177,165,0.7922110877148433,0.0,0.1643835616438356,0
0,0,0,0,0,0.0,0.0,0.0,0
20,105,2100,53,33,0.5959796296701579,0.26789537070497366,0.19047619047619047,0
10,68,680,112,102,0.6668672943909202,0.24456256823018024,0.14705882352941177,0
12,56,672,55,43,0.588362224218974,0.32967049917091934,0.21428571428571427,0
12,51,612,187,175,0.6586333707447549,0.00040242836798958436,0.23529411764705882,0
14,77,1078,49,35,0.691115695347214,0.4396169921188245,0.18181818181818182,0
0,0,0,0,0,0.0,0.0,0.0,0
11,64,704,83,72,1.1638405446001112,0.9379867586452474,0.171875,0
0,0,0,0,0,0.0,0.0,0.0,0
0,0,0,0,0,0.0,0.0,0.0,0
13,72,936,149,136,0.748346733708264,0.228068561407505,0.18055555555555555,0
12,85,1020,182,170,0.6063412057756219,0.0,0.1411764705882353,0
23,31,713,95,72,0.6363462834973191,0.18412337224427527,0.7419354838709677,0
12,75,900,75,63,0.5014467174977058,0.17565365339374786,0.16,0
17,86,1462,63,46,0.7730290606920635,0.6024956608375235,0.19767441860465115,0
11,60,660,126,115,0.7334882691467184,0.1898725687566613,0.18333333333333332,0
0,0,0,0,0,0.0,0.0,0.0,0
0,0,0,0,0,0.0,0.0,0.0,0
20,74,1480,95,75,0.5815873732765512,0.13513029701016582,0.2702702702702703,0
12,69,828,139,127,0.7792126881082733,0.09376150253477897,0.17391304347826086,0
13,53,689,149,136,0.5095141216415672,0.0753317972584188,0.24528301886792453,0
0,0,0,0,0,0.0,0.0,0.0,0
14,47,658,119,105,0.8426182251079496,0.35395403104829676,0.2978723404255319,0
0,0,0,0,0,0.0,0.0,0.0,0
13,87,1131,134,121,0.9492671752966422,0.2024511104204914,0.14942528735632185,0
0,0,0,0,0,0.0,0.0,0.0,0
37,456,16872,185,148,0.48450290913463345,0.0,0.08114035087719298,0
0,0,0,0,0,0.0,0.0,0.0,0
15,89,1335,49,34,0.543412757885841,0.39109297362235074,0.16853932584269662,0
14,68,952,131,117,0.6432203484247245,0.011978328264120486,0.20588235294117646,0
13,64,832,51,38,0.6270293620522281,0.3740754503947868,0.203125,0
14,51,714,187,173,0.6155547761462162,0.0,0.27450980392156865,0
11,57,627,144,133,0.7304192633458177,0.16271893817454866,0.19298245614035087,0
0,0,0,0,0,0.0,0.0,0.0,0
13,58,754,134,121,0.5836441614273946,0.4243097731747682,0.22413793103448276,0
14,86,1204,124,110,0.6450079089169313,0.1467654011670896,0.16279069767441862,0
11,57,627,54,43,0.5034673367748344,0.2771844287524223,0.19298245614035087,0
14,47,658,114,100,0.6088516174421812,0.17847359410774954,0.2978723404255319,0
12,80,960,187,175,0.5924681982252296,0.29079458179433054,0.15,0
23,72,1656,174,151,0.8349985022118039,0.15046876396328265,0.3194444444444444,0
19,45,855,122,103,0.49752686281850766,0.0,0.4222222222222222,0
13,62,806,17,4,0.5765952293181537,0.14460485931764425,0.20967741935483872,0
20,94,1880,152,132,0.711032515644531,0.2524434603291456,0.2127659574468085,0
23,71,1633,141,118,0.6032047474614415,0.3521339681578072,0.323943661971831,0
23,85,1955,131,108,0.8330576676869972,0.5293601918773401,0.27058823529411763,0
10,65,650,187,177,0.6258153271104433,0.2678169751770698,0.15384615384615385,0
11,73,803,53,42,0.6921845635555461,0.32038742762095745,0.1506849315068493,0
0,0,0,0,0,0.0,0.0,0.0,0
15,47,705,50,35,0.522795066593993,0.23512296212341044,0.3191489361702128,0
21,104,2184,171,150,0.6441955229111854,0.0,0.20192307692307693,0
15,44,660,56,41,0.6653847239833944,0.634106333551253,0.3409090909090909,0
0,0,0,0,0,0.0,0.0,0.0,0
13,53,689,152,139,0.6677201419954072,0.3127052358281065,0.24528301886792453,0
14,75,1050,68,54,0.5378341091907154,0.3421354322039693,0.18666666666666668,0
11,64,704,127,116,0.6912327388209901,0.12804759028298698,0.171875,0
13,74,962,124,111,0.649937319525988,0.1351979603757847,0.17567567567567569,0
10,64,640,121,111,0.6859198795048157,0.09410283479510727,0.15625,0
26,86,2236,76,50,0.5593770946179538,0.16953317542089058,0.3023255813953488,0
22,61,1342,68,46,0.49361361402155846,0.17839915073642237,0.36065573770491804,0
11,75,825,120,109,0.6868641647947267,0.11976915493008222,0.14666666666666667,0
12,53,636,152,140,0.6110340798474491,0.03363103868354364,0.22641509433962265,0
18,90,1620,128,110,0.5782112358070988,0.3273894244105814,0.2,0
0,0,0,0,0,0.0,0.0,0.0,0
16,47,752,126,110,0.536979546568938,0.21361122516889075,0.3404255319148936,0
13,86,1118,122,109,0.8029182122466305,0.21345123494841653,0.1511627906976744,0
28,152,4256,67,39,0.5562585133261706,0.18483071600209228,0.18421052631578946,0
15,97,1455,125,110,0.6290174553195295,0.06822094857838785,0.15463917525773196,0
19,44,836,129,110,0.5053274050979015,0.0,0.4318181818181818,0
20,80,1600,171,151,0.5314473445160309,0.07517814709416466,0.25,0
19,33,627,168,149,0.4432138883531325,0.0,0.5757575757575758,0
21,73,1533,108,87,0.5632410225875618,0.32568985037916937,0.2876712328767123,0
0,0,0,0,0,0.0,0.0,0.0,0
19,105,1995,126,107,0.6702590190713191,0.3834571760286835,0.18095238095238095,0
19,80,1520,126,107,0.5743512534594734,0.3837689210211907,0.2375,0
15,74,1110,80,65,0.5723381160177278,0.27587368049806693,0.20270270270270271,0
11,68,748,128,117,0.7092193588554797,0.2488881120019402,0.16176470588235295,0
21,69,1449,108,87,0.6648759986037371,0.45054110724735985,0.30434782608695654,0
35,36,1260,179,144,0.44350870249733904,0.015212577461023126,0.9722222222222222,0
17,42,714,75,58,0.7484251247600865,0.6639785836649434,0.40476190476190477,0
0,0,0,0,0,0.0,0.0,0.0,0
26,160,4160,134,108,0.6105312726209717,0.1882372249400872,0.1625,0
16,60,960,58,42,0.7092261709326415,0.5818037313908094,0.26666666666666666,0
16,82,1312,48,32,0.7022267200137406,0.5189123218228509,0.1951219512195122,0
25,165,4125,129,104,0.9164601337683432,0.8270812996548239,0.15151515151515152,0
16,62,992,93,77,0.567599070870548,0.34033568330835884,0.25806451612903225,0
17,73,1241,62,45,0.6699122980630451,0.4186729440852041,0.2328767123287671,0
15,92,1380,66,51,0.5911063330360979,0.3025118976237499,0.16304347826086957,0
26,103,2678,57,31,0.6490209444295327,0.399388763025624,0.2524271844660194,0
13,60,780,121,108,0.6892409341554862,0.0,0.21666666666666667,0
19,121,2299,62,43,0.599614543820108,0.34716814822440073,0.15702479338842976,0
25,173,4325,56,31,0.596285585650404,0.4267659675574468,0.14450867052023122,0
19,55,1045,61,42,0.5644926375165636,0.30034316581458775,0.34545454545454546,0
18,82,1476,63,45,0.4773186730257254,0.08108988307887152,0.21951219512195122,0
17,87,1479,159,142,0.6139910605955101,0.10104737617584048,0.19540229885057472,0
11,60,660,127,116,0.8400876263328235,0.23801275588255935,0.18333333333333332,0
12,52,624,121,109,0.6821052479920585,0.2219436968526678,0.23076923076923078,0
13,70,910,56,43,0.8092579793217717,0.514603220393933,0.18571428571428572,0
18,93,1674,128,110,0.5615908047623804,0.08954145186849068,0.1935483870967742,0
21,124,2604,85,64,0.5299007398745718,0.1729230863638132,0.1693548387096774,0
28,124,3472,58,30,0.7412032860053434,0.4586172773609468,0.22580645161290322,0
13,71,923,57,44,0.6554214342939844,0.5487120382910099,0.18309859154929578,0
24,159,3816,56,32,0.6708653644344768,0.42457077182367053,0.1509433962264151,0
19,91,1729,127,108,0.8126291686134954,0.1933429546531553,0.2087912087912088,0
24,82,1968,119,95,0.6177123052857687,0.13299601944524916,0.2926829268292683,0
13,79,1027,95,82,0.5313138897986958,0.23416846982390815,0.16455696202531644,0
20,82,1640,101,81,0.5974015886096641,0.20339324900190492,0.24390243902439024,0
14,92,1288,55,41,0.5169277871209798,0.16974873351025407,0.15217391304347827,0
13,80,1040,96,83,0.6520695166703343,0.2077179117006845,0.1625,0
12,78,936,122,110,0.5867161923389436,0.007654269508418281,0.15384615384615385,0
13,55,715,131,118,0.611647360150687,0.20560157661896725,0.23636363636363636,0
15,65,975,99,84,0.5588599709627,0.3849496549340474,0.23076923076923078,0
17,92,1564,155,138,0.5484373264038157,0.1872406653012682,0.18478260869565216,0
14,49,686,97,83,0.5970483621165177,0.49120097788786393,0.2857142857142857,0
15,82,1230,151,136,0.667505666251151,0.1807405255267245,0.18292682926829268,0
13,56,728,124,111,0.8332102966464184,0.30412856665222765,0.23214285714285715,0
0,0,0,0,0,0.0,0.0,0.0,0
13,49,637,159,146,1.2703651728689533,0.4139895221003124,0.2653061224489796,0
10,65,650,85,75,0.7751686882743347,0.5121596058797385,0.15384615384615385,0
14,75,1050,139,125,0.65547755681344,0.20082197463237997,0.18666666666666668,0
14,78,1092,129,115,0.7399217114891723,0.26358726250140063,0.1794871794871795,0
19,49,931,165,146,0.5683895680361631,0.08043870674677116,0.3877551020408163,0
11,70,770,158,147,1.1029275270707026,0.4546070424953473,0.15714285714285714,0
14,60,840,46,32,0.5701636435840318,0.14480856974221806,0.23333333333333334,0
13,72,936,179,166,0.8967547673434723,0.07007039026793659,0.18055555555555555,0
14,60,840,54,40,0.5081736869917857,0.3594706109091668,0.23333333333333334,0
16,85,1360,155,139,0.6118044929661814,0.05546076747683924,0.18823529411764706,0
11,56,616,120,109,0.5596756309747875,0.0,0.19642857142857142,0
24,49,1176,174,150,0.4976539897333011,0.06977040416594889,0.4897959183673469,0
34,63,2142,177,143,0.41805397567908936,0.24599795028857746,0.5396825396825397,0
26,45,1170,175,149,0.41791093509606664,0.0,0.5777777777777777,0
10,64,640,141,131,0.549429073445408,0.05925239588143092,0.15625,0
16,56,896,126,110,0.5074541748756025,0.18349588779974788,0.2857142857142857,0
36,61,2196,187,151,0.40522687000547897,0.0,0.5901639344262295,0
22,48,1056,176,154,0.44070931943557673,0.0,0.4583333333333333,0
24,112,2688,66,42,0.42668851573630046,0.042114919865690284,0.21428571428571427,0
21,33,693,174,153,0.3999307788293996,0.0,0.6363636363636364,0
13,64,832,147,134,0.7257617760477284,0.5551652231603456,0.203125,0
20,71,1420,55,35,0.45008641556752704,0.09208595324377551,0.28169014084507044,0
15,60,900,56,41,0.5140374478113853,0.17181073709043385,0.25,0
27,44,1188,175,148,0.4099584243076597,0.0,0.6136363636363636,0
35,979,34265,67,32,0.5859905929947784,0.3725324382345156,0.03575076608784474,0
37,675,24975,69,32,0.7716161998755796,0.6546012888807408,0.054814814814814816,0
21,77,1617,130,109,0.5986353873334109,0.20781128984173194,0.2727272727272727,0
24,56,1344,174,150,0.5124855101662756,0.0,0.42857142857142855,0
22,107,2354,55,33,0.4436940801516364,0.15146879534104676,0.205607476635514,0
16,97,1552,180,164,0.5165149428557759,0.0,0.16494845360824742,0
14,99,1386,55,41,0.4709576288246435,0.0,0.1414141414141414,0
14,76,1064,132,118,0.500417373455013,0.21622202021993323,0.18421052631578946,0
20,106,2120,186,166,0.3955034944562466,0.0,0.18867924528301888,0
20,92,1840,52,32,0.46492019367786325,0.07049906156032547,0.21739130434782608,0
29,100,2900,172,143,0.43592296962081556,0.0,0.29,0
21,50,1050,131,110,0.5031372268653397,0.0,0.42,0
16,56,896,134,118,0.5124747883145205,0.19766569066421616,0.2857142857142857,0
16,41,656,173,157,0.4393455956712842,0.0,0.3902439024390244,0
13,56,728,52,39,0.44125013802631474,0.13137919795217365,0.23214285714285715,0
25,68,1700,173,148,0.45194001238625664,0.011585697827600123,0.36764705882352944,0
14,59,826,48,34,0.4291882399317222,0.1913290288989712,0.23728813559322035,0
10,71,710,65,55,0.5451292202604314,0.23684488230165177,0.14084507042253522,0
14,97,1358,53,39,0.5369139008423643,0.30352892877757487,0.14432989690721648,0
14,84,1176,155,141,0.6333968759262094,0.1784232673919664,0.16666666666666666,0
12,61,732,55,43,0.5365237733711966,0.021806218711949075,0.19672131147540983,0
12,55,660,183,171,0.5836819710657939,0.09945592345380397,0.21818181818181817,0
17,108,1836,157,140,0.5762123138956318,0.17049995027087622,0.1574074074074074,0
10,62,620,121,111,0.7524691820780819,0.13301664562231474,0.16129032258064516,0
20,125,2500,185,165,0.4722128595034284,0.0,0.16,0
12,84,1008,122,110,0.602724518053152,0.11581307385985166,0.14285714285714285,0
18,49,882,167,149,0.5041483389397658,0.2395001525360598,0.3673469387755102,0
11,59,649,156,145,0.726497608078443,0.09307730947103281,0.1864406779661017,0
22,69,1518,115,93,0.6542611119395066,0.1786212722633685,0.3188405797101449,0
11,74,814,154,143,0.5574272419146385,0.32816090174097867,0.14864864864864866,0
13,52,676,123,110,0.6091817353115979,0.12555925498279252,0.25,0
17,58,986,158,141,0.7305176441213791,0.056810194597977974,0.29310344827586204,0
10,66,660,122,112,0.6012569407032912,0.04284062875434384,0.15151515151515152,0
16,103,1648,158,142,0.8074633864841785,0.3029372050177652,0.1553398058252427,0
16,70,1120,50,34,0.5409915756167645,0.30452382144439255,0.22857142857142856,0
10,66,660,79,69,1.0850767667476606,0.16067868878525549,0.15151515151515152,0
20,136,2720,108,88,0.612278333722565,0.3071785574057632,0.14705882352941177,0
14,74,1036,156,142,1.3174911259809863,0.2673915336899362,0.1891891891891892,0
14,99,1386,55,41,0.5944648051519187,0.42429162154796707,0.1414141414141414,0
20,91,1820,54,34,0.5527549723569672,0.2509625240657873,0.21978021978021978,0
22,81,1782,55,33,0.5570895505016961,0.21591903078379757,0.2716049382716049,0
15,79,1185,158,143,1.0009245431731724,0.6145354079750419,0.189873417721519,0
22,135,2970,96,74,0.5863332358520662,0.16578423560509098,0.16296296296296298,0
18,49,882,49,31,0.5428365479983128,0.2886574515076366,0.3673469387755102,0
12,74,888,96,84,0.793360006616069,0.4217402646844264,0.16216216216216217,0
18,70,1260,96,78,0.6150792822839038,0.4614513942537385,0.2571428571428571,0
13,81,1053,96,83,0.7063019765374656,0.4035229409511999,0.16049382716049382,0
17,121,2057,127,110,0.6158079018645125,0.0,0.14049586776859505,0
12,65,780,130,118,0.6539828572823045,0.2428795327155729,0.18461538461538463,0
19,68,1292,128,109,0.755213448169107,0.5063526426440496,0.27941176470588236,0
19,48,912,130,111,0.6358314832006838,0.25212857251308385,0.3958333333333333,0
15,77,1155,55,40,0.6652832406362066,0.3105752087133044,0.19480519480519481,0
23,114,2622,53,30,0.6267052173824867,0.4564034175924763,0.20175438596491227,0
22,54,1188,55,33,0.6357706558719664,0.3923249917594025,0.4074074074074074,0
13,92,1196,123,110,0.6552064117969583,0.0,0.14130434782608695,0
14,73,1022,187,173,0.7658242415794769,0.038324379703528345,0.1917808219178082,0
12,77,924,122,110,0.7818781615638496,0.3826655839760254,0.15584415584415584,0
11,64,704,175,164,0.7328910362933622,0.0,0.171875,0
18,98,1764,54,36,0.5193159670874881,0.2923944718474524,0.1836734693877551,0
0,0,0,0,0,0.0,0.0,0.0,0
13,85,1105,54,41,0.558841150108047,0.30715715284333617,0.15294117647058825,0
14,62,868,123,109,0.5104051404881562,0.1100858775869836,0.22580645161290322,0
12,60,720,121,109,0.509433851630151,0.0,0.2,0
19,61,1159,129,110,0.4509954777319825,0.0,0.3114754098360656,0
12,73,876,158,146,0.6367822348650423,0.24917611179889462,0.1643835616438356,0
13,63,819,151,138,0.5489869261996786,0.009281278195102405,0.20634920634920634,0
31,58,1798,167,136,0.4967285209856464,0.0,0.5344827586206896,0
18,70,1260,83,65,0.5213416570450969,0.26200159495003583,0.2571428571428571,0
37,148,5476,82,45,0.48140382538686355,0.14471112680995088,0.25,0
21,62,1302,67,46,0.520074852686192,0.2689605461334311,0.3387096774193548,0
21,95,1995,56,35,0.5148936275521248,0.10130641191736744,0.22105263157894736,0
11,78,858,82,71,0.7049545535593457,0.47866252559666844,0.14102564102564102,0
20,90,1800,56,36,0.5470065834005806,0.2576376701584509,0.2222222222222222,0
15,63,945,121,106,0.5782054021785195,0.21757076300394082,0.23809523809523808,0
15,70,1050,80,65,0.5545380752049045,0.21729983275843345,0.21428571428571427,0
46,210,9660,78,32,0.6050160625662057,0.22831177585616874,0.21904761904761905,0
14,62,868,77,63,0.5747613799687384,0.07611421899577957,0.22580645161290322,0
25,112,2800,59,34,0.6996620880708864,0.4333906829544204,0.22321428571428573,0
23,112,2576,65,42,0.707928747189792,0.5793632195626076,0.20535714285714285,0
28,168,4704,60,32,0.6692787522314475,0.5108036409020964,0.16666666666666666,0
28,157,4396,61,33,0.5672841763402781,0.25250612910723386,0.17834394904458598,0
25,84,2100,56,31,0.7257728420414541,0.4565265656274356,0.2976190476190476,0
22,42,924,56,34,0.5855664741742064,0.2503936547372439,0.5238095238095238,0
31,203,6293,63,32,0.7260528906047466,0.4463647331127708,0.15270935960591134,0
14,79,1106,81,67,0.6585639371539778,0.45558470637406756,0.17721518987341772,0
14,59,826,79,65,0.5846569643644777,0.35445201251087266,0.23728813559322035,0
19,61,1159,108,89,0.6512352998059363,0.23857748394724496,0.3114754098360656,0
19,94,1786,81,62,0.570938591843141,0.2421847368104251,0.20212765957446807,0
15,83,1245,123,108,0.6684020303255975,0.11070619663961351,0.18072289156626506,0
20,79,1580,108,88,0.631090740704807,0.33918654134504544,0.25316455696202533,0
19,118,2242,54,35,0.5005612025600821,0.08530605791603671,0.16101694915254236,0
19,130,2470,52,33,0.70438902452789,0.5017654470567301,0.14615384615384616,0
13,80,1040,122,109,0.6596607368591659,0.11123920852816224,0.1625,0
16,57,912,50,34,0.5294681671870648,0.15905941610461946,0.2807017543859649,0
20,64,1280,121,101,0.739727776497491,0.18134481447073134,0.3125,0
12,59,708,155,143,0.7016841378071421,0.1928418898116201,0.2033898305084746,0
22,50,1100,115,93,0.6647012472082379,0.09700062292110535,0.44,0
16,43,688,126,110,0.5236693913469259,0.000771174186417602,0.37209302325581395,0
26,101,2626,96,70,0.5361895868405381,0.3438292017747222,0.25742574257425743,0
27,24,648,179,152,0.5242562722733821,0.12857492336028573,1.125,0
15,43,645,95,80,0.5645690799268682,0.1355513905207156,0.3488372093023256,0
20,83,1660,128,108,0.6288769559242428,0.36425841139299786,0.24096385542168675,0
17,93,1581,127,110,0.7895359620463717,0.4784756434922585,0.1827956989247312,0
18,78,1404,59,41,0.6046985593076875,0.3829824612147662,0.23076923076923078,0
15,77,1155,99,84,0.5885275937317374,0.4857939714144572,0.19480519480519481,0
16,68,1088,97,81,0.6139112978840022,0.11089946639059409,0.23529411764705882,0
21,58,1218,115,94,0.7755166023544149,0.0,0.3620689655172414,0
19,113,2147,129,110,0.580497174115893,0.0,0.168141592920354,0
13,59,767,152,139,0.7125200435660849,0.24262659612233078,0.22033898305084745,0
21,70,1470,131,110,0.6582463969392985,0.10401688593861913,0.3,0
24,93,2232,134,110,0.5759220579425445,0.05816892730969419,0.25806451612903225,0
17,110,1870,56,39,0.6161187521469231,0.4224118707626659,0.15454545454545454,0
16,92,1472,55,39,0.5339976762861509,0.2181217720307225,0.17391304347826086,0
24,108,2592,56,32,0.5993383291223361,0.13219063551752258,0.2222222222222222,0
13,77,1001,187,174,0.8573506445794161,0.2937833879127287,0.16883116883116883,0
18,81,1458,96,78,0.7241167494304254,0.4410204707023051,0.2222222222222222,0
24,73,1752,55,31,0.5789083963846247,0.2854756351184115,0.3287671232876712,0
16,80,1280,48,32,0.5737176226989039,0.27659456256460824,0.2,0
0,0,0,0,0,0.0,0.0,0.0,0
18,104,1872,126,108,0.5623073524547963,0.0,0.17307692307692307,0
13,73,949,53,40,0.5469782093260733,0.2996490264740831,0.1780821917808219,0
16,98,1568,164,148,0.8720362215979087,0.3135683546649444,0.16326530612244897,0
24,44,1056,173,149,0.4295164267408674,0.0,0.5454545454545454,0
23,124,2852,54,31,0.5619194926081703,0.2511190488634668,0.18548387096774194,0
13,77,1001,121,108,0.56798643510964,0.0,0.16883116883116883,0
17,75,1275,56,39,0.489582256373354,0.37257936153366855,0.22666666666666666,0
34,781,26554,68,34,0.5982861191736334,0.3841700511524425,0.04353393085787452,0
11,59,649,122,111,0.6001756361483813,0.12294205862408522,0.1864406779661017,0
26,47,1222,175,149,0.4222268332415668,0.0,0.5531914893617021,0
46,55,2530,187,141,0.5619238825254339,0.10069212247653125,0.8363636363636363,0
44,854,37576,78,34,0.5876782256600978,0.3642023419930992,0.05152224824355972,0
33,900,29700,68,35,0.6509683718202885,0.5065919334669395,0.03666666666666667,0
34,1331,45254,68,34,0.5501621508452543,0.3650763250710384,0.025544703230653644,0
19,89,1691,55,36,0.45236037702726195,0.24315917703118356,0.21348314606741572,0
16,41,656,175,159,0.44158530193839923,0.07984034321046632,0.3902439024390244,0
12,55,660,177,165,0.6609330021694015,0.0,0.21818181818181817,0
44,914,40216,78,34,0.8023051120719826,0.725826621407425,0.04814004376367615,0
35,727,25445,76,41,0.6650666675644321,0.4776328018064077,0.048143053645116916,0
34,472,16048,68,34,0.6558053296968633,0.5223065829512838,0.07203389830508475,0
13,52,676,123,110,0.5619637967212965,0.3099283160278141,0.25,0
21,68,1428,175,154,0.41159893683185217,0.0,0.3088235294117647,0
16,47,752,182,166,0.4896651649725936,0.0,0.3404255319148936,0
18,94,1692,150,132,0.46202772552040966,0.07520651116137717,0.19148936170212766,0
11,76,836,121,110,0.4679942978419569,0.07932732978042675,0.14473684210526316,0
12,70,840,177,165,0.6063254337853731,0.0,0.17142857142857143,0
18,42,756,171,153,0.46321082901025523,0.0,0.42857142857142855,0
11,66,726,121,110,0.46142638741160036,0.0,0.16666666666666666,0
21,118,2478,148,127,0.500046896511092,0.021976206360474235,0.17796610169491525,0
11,70,770,151,140,0.5633908231724678,0.33690176523850823,0.15714285714285714,0
11,73,803,177,166,0.8979740040123544,0.282064964013578,0.1506849315068493,0
19,57,1083,182,163,0.4597984337575209,0.0,0.3333333333333333,0
24,44,1056,172,148,0.4440155175591901,0.09815809558767058,0.5454545454545454,0
11,57,627,175,164,0.5917602002225226,0.0,0.19298245614035087,0
29,153,4437,174,145,0.39233602746728335,0.06712839691618945,0.1895424836601307,0
24,164,3936,56,32,0.5558379487768456,0.28004585064108656,0.14634146341463414,0
14,83,1162,124,110,0.7450437882859197,0.20173134859873867,0.1686746987951807,0
23,157,3611,54,31,0.5712596049239396,0.3395925135835782,0.1464968152866242,0
18,46,828,127,109,0.6834818406915083,0.30771016952445607,0.391304347826087,0
23,133,3059,55,32,0.5482510173517815,0.32669643749671584,0.17293233082706766,0
17,107,1819,55,38,0.49101155187012224,0.21204229635208097,0.1588785046728972,0
20,121,2420,129,109,0.669229382505485,0.4169957145007383,0.1652892561983471,0
17,52,884,128,111,0.5408931229140144,0.0,0.3269230769230769,0
12,62,744,97,85,0.5501350675379195,0.360862732022321,0.1935483870967742,0
12,62,744,175,163,0.7778819407543067,0.05504766597214834,0.1935483870967742,0
20,77,1540,102,82,0.5609000985288174,0.16993495950681559,0.2597402597402597,0
14,75,1050,152,138,0.529467182555444,0.0,0.18666666666666668,0
15,85,1275,54,39,0.5114574854218199,0.23122422191456762,0.17647058823529413,0
16,76,1216,55,39,0.549710825886077,0.24910616171943492,0.21052631578947367,0
16,54,864,179,163,0.7670271885231431,0.0,0.2962962962962963,0
95,152,14440,187,92,0.8306747461696531,0.5953435390518385,0.625,1
14,71,994,53,39,0.5526135706230971,0.2126021149116625,0.19718309859154928,0
18,40,720,156,138,0.9454931945546886,0.12830055644824193,0.45,0
16,52,832,127,111,0.6336888964429207,0.1770883738857429,0.3076923076923077,0
12,75,900,182,170,0.5339267539177918,0.08344979869233908,0.16,0
18,127,2286,128,110,0.608976870582309,0.05504579147912692,0.14173228346456693,0
0,0,0,0,0,0.0,0.0,0.0,0
13,68,884,124,111,0.5917850486543192,0.2875445262377087,0.19117647058823528,0
14,58,812,182,168,0.4850218938220396,0.0,0.2413793103448276,0
11,58,638,121,110,0.609717740101994,0.2784430727259469,0.1896551724137931,0
11,65,715,44,33,0.6417697281911865,0.3389709604818904,0.16923076923076924,0
12,55,660,121,109,0.6304976322164749,0.0,0.21818181818181817,0
11,59,649,183,172,0.7145188014044842,0.061386734262411785,0.1864406779661017,0
14,96,1344,165,151,0.6794959909834012,0.23115565320620915,0.14583333333333334,0
29,66,1914,178,149,0.5546053887007747,0.33065789333003764,0.4393939393939394,0
31,299,9269,64,33,0.5057394145391236,0.25297744538108635,0.10367892976588629,0
21,94,1974,65,44,0.5574071819971916,0.3063612156463242,0.22340425531914893,0
42,140,5880,176,134,0.8322949171668561,0.25771186157131226,0.3,0
54,85,4590,187,133,0.3494785384327665,0.0,0.6352941176470588,0
11,56,616,187,176,0.6104782952043905,0.0,0.19642857142857142,0
20,60,1200,67,47,0.4383658775419048,0.16900101484514257,0.3333333333333333,0
24,118,2832,67,43,0.4407457248337498,0.08135962855523055,0.2033898305084746,0
23,46,1058,164,141,0.46980171922544745,0.10412832024878545,0.5,0
17,51,867,115,98,0.6031446752395557,0.0,0.3333333333333333,0
23,57,1311,151,128,0.4915908987478413,0.08419723861193205,0.40350877192982454,0
21,43,903,172,151,0.43457099782410674,0.0,0.4883720930232558,0
12,65,780,122,110,0.531611321771692,0.16236856941897124,0.18461538461538463,0
0,0,0,0,0,0.0,0.0,0.0,0
10,71,710,155,145,0.8933189731586458,0.1770729375206498,0.14084507042253522,0
12,83,996,55,43,0.6016951356006933,0.30766961911927976,0.14457831325301204,0
18,77,1386,115,97,0.5739445212444779,0.03772913389522511,0.23376623376623376,0
21,118,2478,131,110,0.6667607951151273,0.5028035100049918,0.17796610169491525,0
15,64,960,123,108,0.5617674473163443,0.1159548895494946,0.234375,0
14,75,1050,124,110,0.4882779482874966,0.07483323500460548,0.18666666666666668,0
19,90,1710,115,96,0.6315993276463111,0.10247998450864057,0.2111111111111111,0
14,58,812,131,117,0.66234371901469,0.22799933752609766,0.2413793103448276,0
18,113,2034,51,33,0.5575714027038009,0.2668738674805903,0.1592920353982301,0
21,44,924,172,151,0.45070587434954723,0.0,0.4772727272727273,0
14,68,952,177,163,0.49873511329248604,0.0,0.20588235294117646,0
12,72,864,121,109,0.46519555499245324,0.0,0.16666666666666666,0
10,61,610,155,145,0.8051189309704796,0.3201743881931053,0.16393442622950818,0
23,107,2461,66,43,0.5842049395815903,0.365102916338909,0.21495327102803738,0
11,69,759,54,43,0.5289046869350298,0.37102446620739893,0.15942028985507245,0
15,61,915,125,110,0.5504122562402622,0.054501170796048645,0.2459016393442623,0
14,97,1358,56,42,0.5985966980423584,0.5386326859006061,0.14432989690721648,0
15,75,1125,131,116,0.5867056772837845,0.18760671421411565,0.2,0
18,51,918,55,37,0.5762622460212388,0.24824992567300128,0.35294117647058826,0
24,65,1560,132,108,0.8221567511610383,0.05147836924563199,0.36923076923076925,0
18,50,900,128,110,0.5214741090437607,0.18832991418536732,0.36,0
29,77,2233,67,38,0.4837360923640461,0.14438494316051503,0.37662337662337664,0
11,57,627,151,140,0.8069136145003746,0.25945712293375683,0.19298245614035087,0
11,67,737,123,112,0.8775818844666704,0.09825540321983686,0.16417910447761194,0
14,96,1344,178,164,0.671789480729377,0.027852875882849785,0.14583333333333334,0
11,63,693,121,110,0.5417090316754711,0.01287367654359298,0.1746031746031746,0
16,58,928,128,112,0.7327794287917939,0.025676101939222273,0.27586206896551724,0
13,81,1053,123,110,0.6427656579196538,0.31470593440208183,0.16049382716049382,0
11,65,715,122,111,0.9211557321247456,0.2405881133046953,0.16923076923076924,0
15,63,945,55,40,0.5150222069701448,0.23369969250007058,0.23809523809523808,0
16,99,1584,69,53,0.529425101379096,0.15619171998394327,0.16161616161616163,0
15,78,1170,125,110,0.5821029118995952,0.18437885613786684,0.19230769230769232,0
15,77,1155,56,41,0.5548372082739152,0.41072474240584844,0.19480519480519481,0
15,99,1485,56,41,0.5754510296443095,0.23755036204729027,0.15151515151515152,0
14,86,1204,187,173,0.7412111149924541,0.09270949479922386,0.16279069767441862,0
16,83,1328,126,110,0.539978541152358,0.051729084180142645,0.1927710843373494,0
20,41,820,174,154,0.4874717887533864,0.0,0.4878048780487805,0
17,82,1394,57,40,0.5675358827269233,0.5289229643697454,0.2073170731707317,0
37,169,6253,69,32,0.5390760289098998,0.30697297712048166,0.21893491124260356,0
23,160,3680,63,40,0.4670304091572735,0.177359031857231,0.14375,0
15,101,1515,80,65,0.6427466031927301,0.5636951224714838,0.1485148514851485,0
15,48,720,48,33,0.529801047875075,0.2870040360400229,0.3125,0
11,56,616,78,67,0.6244288394677805,0.4239751470703153,0.19642857142857142,0
15,101,1515,80,65,0.5576994198623151,0.3522554765720731,0.1485148514851485,0
18,96,1728,52,34,0.4493665691265566,0.1012668357127152,0.1875,0
0,0,0,0,0,0.0,0.0,0.0,0
31,40,1240,175,144,0.4650007821259565,0.052316113093543656,0.775,0
14,58,812,115,101,0.6193264874466224,0.18886297160101448,0.2413793103448276,0
17,71,1207,119,102,0.5126679809192102,0.2535362442292208,0.23943661971830985,0
13,51,663,121,108,0.6458277608647282,0.1913612639070531,0.2549019607843137,0
20,76,1520,54,34,0.46360472430930827,0.1077285044548266,0.2631578947368421,0
18,94,1692,50,32,0.5828959360289881,0.4564316845830653,0.19148936170212766,0
21,122,2562,53,32,0.5399390297050215,0.318327227865292,0.1721311475409836,0
16,77,1232,55,39,0.5249960946554714,0.07717436342358887,0.2077922077922078,0
0,0,0,0,0,0.0,0.0,0.0,0
15,84,1260,123,108,0.6220424025695136,0.11103379467274675,0.17857142857142858,0
18,60,1080,115,97,0.6175457046382942,0.1475952643612563,0.3,0
25,136,3400,67,42,0.5577708383725483,0.3513210916897954,0.18382352941176472,0
31,176,5456,122,91,0.652202763473967,0.24213077569429087,0.17613636363636365,0
28,103,2884,122,94,0.5829555309543087,0.1172296157903386,0.27184466019417475,0
31,168,5208,124,93,0.5976079606599516,0.12999564625766286,0.18452380952380953,0
10,67,670,55,45,0.598660216819026,0.5803909613172051,0.14925373134328357,0
0,0,0,0,0,0.0,0.0,0.0,0
13,82,1066,56,43,0.5666230063006861,0.31173513765169153,0.15853658536585366,0
25,104,2600,57,32,0.5382495266631471,0.17222922224489373,0.2403846153846154,0
0,0,0,0,0,0.0,0.0,0.0,0
23,126,2898,54,31,0.5590790842752432,0.26484390619907083,0.18253968253968253,0
23,139,3197,55,32,0.5102455112979611,0.147956334191091,0.16546762589928057,0
66,208,13728,187,121,0.6728470297211357,0.3861570918741435,0.3173076923076923,1
44,78,3432,187,143,0.7381288406862924,0.3910531058442377,0.5641025641025641,1
11,74,814,56,45,0.6948841222767237,0.5358248850343804,0.14864864864864866,0
22,157,3454,97,75,0.5635713954289329,0.35836485526880685,0.14012738853503184,0
16,102,1632,57,41,0.5835899864502112,0.4040609791846206,0.1568627450980392,0
18,70,1260,65,47,0.49234318503676416,0.05905716806470381,0.2571428571428571,0
12,53,636,131,119,0.529732900225247,0.2852193958069512,0.22641509433962265,0
45,77,3465,187,142,0.7288233308618595,0.5661798903024745,0.5844155844155844,1
23,43,989,187,164,0.4338842524660705,0.0,0.5348837209302325,0
51,261,13311,81,30,0.5756912070728669,0.26515406585710144,0.19540229885057472,0
55,42,2310,187,132,0.3467264317490312,0.0,1.3095238095238095,0
21,96,2016,96,75,0.6800092670810823,0.2873286443459824,0.21875,0
34,42,1428,178,144,0.46001494204014853,0.09418792494016016,0.8095238095238095,0
20,56,1120,68,48,0.5287250918104137,0.07062439791013826,0.35714285714285715,0
89,314,27946,187,98,1.0348393732587529,0.6878769710214749,0.28343949044585987,1
32,594,19008,64,32,0.4476061251899181,0.12534291461567668,0.05387205387205387,0
12,57,684,155,143,0.5173689546825397,0.03912911096050754,0.21052631578947367,0
14,95,1330,56,42,0.44614259565541625,0.07800627593964544,0.14736842105263157,0
12,80,960,122,110,0.5626488801686319,0.022036995649243975,0.15,0
12,77,924,152,140,0.5106043645195748,0.25024120024202867,0.15584415584415584,0
36,67,2412,125,89,0.5427295035712195,0.06373901033255835,0.5373134328358209,0
13,75,975,65,52,0.5168522149420938,0.27841929921272446,0.17333333333333334,0
24,158,3792,56,32,0.5909586542119182,0.360609112059625,0.1518987341772152,0
14,54,756,60,46,0.520452062862402,0.3673126192356862,0.25925925925925924,0
22,68,1496,54,32,0.6403242671749444,0.24406478573274207,0.3235294117647059,0
21,86,1806,63,42,0.544579719573687,0.3212447255715947,0.2441860465116279,0
24,94,2256,97,73,0.6064206568256256,0.20805237482748204,0.2553191489361702,0
42,119,4998,187,145,0.9333076469571561,0.37873092514091083,0.35294117647058826,1
21,55,1155,54,33,0.4754715327001087,0.2527292870080549,0.38181818181818183,0
14,62,868,179,165,0.813956737307905,0.0,0.22580645161290322,0
14,82,1148,114,100,0.6403263933843008,0.02830145829825764,0.17073170731707318,0
11,72,792,54,43,0.5249611356411493,0.2274239519935148,0.1527777777777778,0
0,0,0,0,0,0.0,0.0,0.0,0
23,69,1587,55,32,0.4875089277929705,0.08176575571430247,0.3333333333333333,0
28,33,924,175,147,0.5021255041967045,0.28052218763810005,0.8484848484848485,0
20,78,1560,95,75,0.49750757104332166,0.24544495501049954,0.2564102564102564,0
23,82,1886,67,44,0.5004894596064056,0.1952336036841849,0.2804878048780488,0
13,81,1053,124,111,0.807299954792204,0.18303947149972094,0.16049382716049382,0
17,66,1122,153,136,0.45993807499129225,0.1257938254637472,0.25757575757575757,0
22,64,1408,171,149,0.7589950969228303,0.18395997377825124,0.34375,0
12,68,816,122,110,0.9152518088521614,0.21230557705303174,0.17647058823529413,0
12,73,876,54,42,0.5352686376622651,0.2349098664209465,0.1643835616438356,0
18,115,2070,81,63,0.506675468781501,0.17439544820792294,0.1565217391304348,0
16,103,1648,81,65,0.5387199734108615,0.24798285820111832,0.1553398058252427,0
17,84,1428,164,147,0.5059481406842938,0.18586095780643413,0.20238095238095238,0
14,79,1106,177,163,0.7042907972434634,0.0,0.17721518987341772,0
11,78,858,128,117,0.7693799508302993,0.520841041422683,0.14102564102564102,0
20,59,1180,115,95,0.6390520341230296,0.17666349415116012,0.3389830508474576,0
16,53,848,125,109,0.5439252295431323,0.2370745459139335,0.3018867924528302,0
15,93,1395,123,108,0.6516193274721243,0.17944983840845566,0.16129032258064516,0
13,47,611,123,110,0.5308649732180254,0.17787205573980056,0.2765957446808511,0
18,76,1368,167,149,0.4652833799731703,0.16802117086804652,0.23684210526315788,0
13,79,1027,123,110,0.649635986724912,0.24435879141537617,0.16455696202531644,0
15,91,1365,48,33,0.7346973011398685,0.3448406175998745,0.16483516483516483,0
15,62,930,161,146,0.7575887723901985,0.10099918298864878,0.24193548387096775,0
14,65,910,187,173,0.667155072945795,0.042796849080072884,0.2153846153846154,0
14,63,882,164,150,0.7181153683125797,0.20085995910123358,0.2222222222222222,0
22,138,3036,55,33,0.5032034310966802,0.11964052189740357,0.15942028985507245,0
13,88,1144,122,109,0.6974489603276067,0.006787122569295721,0.14772727272727273,0
25,124,3100,187,162,0.6296012529880028,0.274033740499519,0.20161290322580644,0
115,139,15985,187,72,0.5840417211026817,0.2607833257379121,0.8273381294964028,1
15,81,1215,95,80,0.4950153498849028,0.24711347461476663,0.18518518518518517,0
19,66,1254,130,111,0.5056870785972921,0.10663973184436225,0.2878787878787879,0
22,40,880,173,151,0.4491470780946749,0.0,0.55,0
20,140,2800,131,111,0.4457648405737736,0.0052019480203199745,0.14285714285714285,0
20,108,2160,54,34,0.5094931173291517,0.36253985235565345,0.18518518518518517,0
10,64,640,153,143,0.48238719932177193,0.2832456288095358,0.15625,0
22,96,2112,55,33,0.4687948645914435,0.13231008549950304,0.22916666666666666,0
22,145,3190,54,32,0.5069883477405195,0.261269488633518,0.15172413793103448,0
15,47,705,125,110,0.5362159348618724,0.04266434736444486,0.3191489361702128,0
19,105,1995,128,109,0.48374250002406516,0.22694107186293289,0.18095238095238095,0
15,48,720,187,172,0.47545055271107317,0.05866878591195784,0.3125,0
25,63,1575,176,151,0.4722387512309123,0.07113990901178181,0.3968253968253968,0
22,140,3080,131,109,0.43629287833205627,0.05940132600496463,0.15714285714285714,0
16,49,784,126,110,0.5814911885731071,0.30850329212811417,0.32653061224489793,0
12,68,816,122,110,0.6125634752752346,0.10830893406228066,0.17647058823529413,0
14,93,1302,45,31,0.6014765677667832,0.37700395182999424,0.15053763440860216,0
13,86,1118,57,44,0.6296851703494714,0.48738193446682415,0.1511627906976744,0
22,38,836,171,149,0.41353722710755275,0.0,0.5789473684210527,0
0,0,0,0,0,0.0,0.0,0.0,0
13,90,1170,54,41,0.468388746872502,0.15980387004490826,0.14444444444444443,0
26,47,1222,175,149,0.42171723162251973,0.0,0.5531914893617021,0
12,68,816,122,110,0.5647070580752723,0.03312338212125858,0.17647058823529413,0
70,132,9240,187,117,0.861158323087881,0.41086215175882657,0.5303030303030303,1
14,76,1064,153,139,0.6437162211626583,0.08969801133328348,0.18421052631578946,0
12,70,840,121,109,0.641384575614197,0.0,0.17142857142857143,0
19,46,874,53,34,0.5089930293075445,0.12932559866767945,0.41304347826086957,1
13,67,871,47,34,0.5045660980296056,0.1515711040697228,0.19402985074626866,0
15,65,975,163,148,0.5086122902295509,0.0,0.23076923076923078,0
13,75,975,66,53,0.5634202832996544,0.3322573728975826,0.17333333333333334,0
12,54,648,46,34,0.6362130966253895,0.18045377682233923,0.2222222222222222,0
18,54,972,120,102,0.590084713662821,0.05524182513946106,0.3333333333333333,0
12,62,744,177,165,0.4918378757269074,0.0,0.1935483870967742,0
21,95,1995,96,75,0.4387750809787121,0.10290822203133367,0.22105263157894736,0
35,216,7560,67,32,0.4404133089067744,0.09674425845183358,0.16203703703703703,0
14,85,1190,123,109,0.5634976440374648,0.1416555202601538,0.16470588235294117,0
21,108,2268,97,76,0.515949270478598,0.16181377793115873,0.19444444444444445,0
14,88,1232,176,162,0.5884788365008743,0.0,0.1590909090909091,0
19,54,1026,125,106,0.5582336474739087,0.00445834834297175,0.35185185185185186,0
17,56,952,156,139,0.5458223975278244,0.0811735010557225,0.30357142857142855,0
22,115,2530,98,76,0.49886476750185343,0.2002976444902403,0.19130434782608696,0
21,100,2100,97,76,0.5144266937889838,0.2208541657604233,0.21,0
40,89,3560,187,147,0.6318318617453974,0.41569897893282604,0.449438202247191,1
13,53,689,153,140,0.5830904215898788,0.13105192312696543,0.24528301886792453,0
14,89,1246,178,164,0.756030683320205,0.0,0.15730337078651685,0
44,75,3300,187,143,0.607862707429548,0.4017873625359539,0.5866666666666667,1
41,157,6437,187,146,0.5416144060171134,0.20105097326239152,0.2611464968152866,1
11,66,726,121,110,0.7100472327098576,0.04819212948774669,0.16666666666666666,0
41,85,3485,187,146,0.6502208605849917,0.4420834139071682,0.4823529411764706,1
133,200,26600,187,54,1.1041993133996117,0.7230352666818971,0.665,1
103,147,15141,187,84,0.9125184874733512,0.6016697521465071,0.7006802721088435,1
32,24,768,187,155,0.4990559614270719,0.10002771553832983,1.3333333333333333,0
24,91,2184,98,74,0.5419148209560118,0.2356045584424607,0.26373626373626374,0
14,55,770,122,108,0.615220144292577,0.26174933573002157,0.2545454545454545,0
23,41,943,173,150,0.45002656722086853,0.0,0.5609756097560976,0
39,58,2262,187,148,0.5785605412051615,0.277238673290207,0.6724137931034483,0
102,178,18156,187,85,1.1557466006052357,0.8099397054855474,0.5730337078651685,1
33,100,3300,108,75,0.4885033327869496,0.2079199083345851,0.33,0
12,62,744,176,164,0.5798488225070949,0.5171697152129178,0.1935483870967742,0
65,151,9815,187,122,0.7306070222670185,0.45218328919865164,0.4304635761589404,1
23,87,2001,97,74,0.638023394376437,0.2992520231659194,0.26436781609195403,0
124,102,12648,187,63,0.9299639321900153,0.44167239998324925,1.2156862745098038,1
144,206,29664,187,43,1.3929239845210446,0.7649865257141358,0.6990291262135923,1
13,66,858,57,44,0.6258835082633938,0.408339124751186,0.19696969696969696,0
24,77,1848,187,163,0.7759841880684352,0.6282271759062289,0.3116883116883117,1
45,138,6210,187,142,0.7003654186037243,0.4110882331640214,0.32608695652173914,1
99,121,11979,187,88,0.8947714393749007,0.46791677983129365,0.8181818181818182,1
87,144,12528,187,100,0.8400044146369704,0.40680628828144805,0.6041666666666666,1
18,98,1764,95,77,0.6900868240201192,0.5110278431410941,0.1836734693877551,0
11,61,671,129,118,0.7267538161813929,0.2405388891929215,0.18032786885245902,0
16,47,752,133,117,0.6823827158392368,0.1846532035808307,0.3404255319148936,0
19,80,1520,97,78,0.718128571448586,0.4566889911102082,0.2375,0
12,54,648,179,167,0.7465088711422109,0.1522451855187334,0.2222222222222222,0
70,155,10850,187,117,0.666803509009023,0.3564345304828037,0.45161290322580644,1
16,76,1216,95,79,0.5669184333128564,0.17994873380310752,0.21052631578947367,0
24,53,1272,187,163,0.7330322009796973,0.40101826998283513,0.4528301886792453,1
41,89,3649,187,146,0.6108345740445125,0.28589856905101135,0.4606741573033708,1
21,72,1512,95,74,0.7092798956977093,0.2981985961644749,0.2916666666666667,0
88,98,8624,187,99,0.9660834827574238,0.5187174462770832,0.8979591836734694,1
31,72,2232,187,156,0.6177044865565575,0.48150179915479263,0.4305555555555556,1
21,91,1911,186,165,0.5592867971914766,0.46051880848090093,0.23076923076923078,0
10,71,710,182,172,0.664141793993452,0.0932635596610964,0.14084507042253522,0
23,52,1196,157,134,0.6222655618068647,0.14698903838982333,0.4423076923076923,0
23,107,2461,99,76,0.536273046813174,0.18878206286441193,0.21495327102803738,0
18,69,1242,170,152,0.4427355127639962,0.0,0.2608695652173913,0
22,70,1540,175,153,0.49443373481241193,0.0,0.3142857142857143,0
14,69,966,157,143,0.4448918812544366,0.025392147274565357,0.2028985507246377,0
21,66,1386,54,33,0.4739102047206718,0.17689595602184235,0.3181818181818182,0
11,61,671,54,43,0.4431046222102135,0.16407995182921756,0.18032786885245902,0
19,64,1216,165,146,0.4838191703604475,0.05514227687704973,0.296875,0
22,47,1034,175,153,0.4449219227241743,0.0,0.46808510638297873,0
23,96,2208,55,32,0.5375880528995668,0.23370704508428275,0.23958333333333334,0
22,114,2508,55,33,0.4382971555776613,0.17952340192482913,0.19298245614035087,0
10,65,650,150,140,0.48905058663129564,0.0,0.15384615384615385,0
21,94,1974,96,75,0.4424029923616077,0.09762248312726755,0.22340425531914893,0
41,102,4182,187,146,0.6190800086750687,0.26394501973589735,0.4019607843137255,1
33,109,3597,96,63,0.5217733104539051,0.19205053298941818,0.30275229357798167,0
23,108,2484,55,32,0.5569710608325893,0.0735437258546872,0.21296296296296297,0
19,87,1653,95,76,0.4595329291299564,0.1669514299301537,0.21839080459770116,0
22,141,3102,55,33,0.4896129501876699,0.272235361356507,0.15602836879432624,0
11,67,737,121,110,0.4957613236858866,0.0,0.16417910447761194,0
13,64,832,176,163,0.8316091715864731,0.0,0.203125,0
14,57,798,122,108,0.5556773788651435,0.05329256531085494,0.24561403508771928,0
13,62,806,123,110,0.52306171868057,0.041238596601075324,0.20967741935483872,0
22,103,2266,96,74,0.4854826507785016,0.18949532491461288,0.21359223300970873,0
29,106,3074,139,110,0.4455442379213543,0.10102128706325265,0.27358490566037735,0
21,108,2268,96,75,0.5248755596250426,0.1805240210941474,0.19444444444444445,0
17,82,1394,125,108,0.5569015069444255,0.158996565536681,0.2073170731707317,0
20,56,1120,159,139,0.5510986330360347,0.02741140497264619,0.35714285714285715,0
22,146,3212,97,75,0.5350107753576822,0.23748853906978626,0.1506849315068493,0
89,122,10858,187,98,0.9476957992422158,0.5969622405245417,0.7295081967213115,1
43,82,3526,187,144,0.4549471616684695,0.14061225567962832,0.524390243902439,0
19,84,1596,116,97,0.6848217948986401,0.03180242801722281,0.2261904761904762,0
56,107,5992,187,131,0.5775696063060785,0.22658445861718612,0.5233644859813084,1
22,133,2926,54,32,0.5915918997732668,0.42850467809540876,0.16541353383458646,0
22,46,1012,171,149,0.4659288245087626,0.0,0.4782608695652174,0
20,76,1520,54,34,0.47466426898302516,0.0,0.2631578947368421,0
16,67,1072,125,109,0.6772718000010982,0.2155581227363889,0.23880597014925373,0
15,100,1500,124,109,0.5396586493528351,0.04871375861726178,0.15,0
25,159,3975,157,132,0.628107628714126,0.06374221220394126,0.15723270440251572,0
33,121,3993,66,33,0.48056078669453917,0.23142983546359935,0.2727272727272727,0
13,84,1092,130,117,0.7064417690504406,0.14595647527375794,0.15476190476190477,0
17,100,1700,63,46,0.5830442442835558,0.2912478675920269,0.17,0
17,76,1292,108,91,0.7833764528352155,0.27581345100239163,0.2236842105263158,0
28,73,2044,60,32,0.5797467364195917,0.34027580462010426,0.3835616438356164,0
27,114,3078,58,31,0.6773481973917004,0.44711057925817344,0.23684210526315788,0
14,99,1386,55,41,0.4891713122207381,0.23453643564616797,0.1414141414141414,0
27,174,4698,68,41,0.6032837166438664,0.11978022167289501,0.15517241379310345,0
14,49,686,48,34,0.5357159184515701,0.3635072416470228,0.2857142857142857,0
45,116,5220,177,132,0.564618880855268,0.3362123828079488,0.3879310344827586,1
21,115,2415,54,33,0.583154481906039,0.4023562906981083,0.1826086956521739,0
11,71,781,121,110,0.7682091916499345,0.0,0.15492957746478872,0
12,68,816,153,141,0.790360866346739,0.3505935245444137,0.17647058823529413,0
12,72,864,54,42,0.5002338849876838,0.2579030974160826,0.16666666666666666,0
11,61,671,175,164,0.8066153507737556,0.314438835116082,0.18032786885245902,0
13,54,702,123,110,0.5237480066077086,0.0,0.24074074074074073,0
24,121,2904,56,32,0.574655041108672,0.2621734510923427,0.19834710743801653,0
12,67,804,55,43,0.5724229353391416,0.27823543749046875,0.1791044776119403,0
21,81,1701,54,33,0.5195639534248881,0.2496603131102769,0.25925925925925924,0
18,71,1278,51,33,0.6883103765312869,0.34460557737761727,0.2535211267605634,0
12,70,840,129,117,0.5559185731340236,0.3514024794027027,0.17142857142857143,0
23,121,2783,115,92,0.7019562404942963,0.22628765855805485,0.19008264462809918,0
12,82,984,147,135,0.5538141717630373,0.0054524865157372275,0.14634146341463414,0
11,56,616,187,176,0.679390449518299,0.0,0.19642857142857142,0
14,78,1092,157,143,0.9182115642130462,0.26161511425732686,0.1794871794871795,0
20,112,2240,53,33,0.44496390187825396,0.15379795056051446,0.17857142857142858,0
14,90,1260,97,83,0.5143804232427908,0.23796081403595482,0.15555555555555556,0
21,78,1638,54,33,0.4502062461838696,0.056328886425066546,0.2692307692307692,0
34,55,1870,177,143,0.4718763341017314,0.15353685660320218,0.6181818181818182,0
26,48,1248,173,147,0.3932054098164359,0.0,0.5416666666666666,1
11,56,616,155,144,0.4415289871007479,0.0,0.19642857142857142,0
17,61,1037,182,165,0.5031574378351298,0.0,0.2786885245901639,0
12,63,756,122,110,0.48790786291462374,0.0,0.19047619047619047,0
17,36,612,154,137,0.41099893847191593,0.0,0.4722222222222222,0
14,63,882,48,34,0.5432012089998853,0.18419455980487792,0.2222222222222222,0
12,73,876,122,110,0.46117222740514435,0.0,0.1643835616438356,0
18,77,1386,153,135,0.5569426374327682,0.02096774496586014,0.23376623376623376,0
37,80,2960,187,150,0.449848765226273,0.0,0.4625,0
14,53,742,123,109,0.42602178501221943,0.0,0.2641509433962264,0
11,64,704,121,110,0.5540696326315536,0.09537889647320139,0.171875,0
12,79,948,121,109,0.657276670513323,0.06868697641569547,0.1518987341772152,0
26,162,4212,68,42,0.4333957980524747,0.10054600633388405,0.16049382716049382,0
0,0,0,0,0,0.0,0.0,0.0,0
18,101,1818,159,141,0.6422789246248254,0.16424571199957874,0.1782178217821782,0
28,51,1428,152,124,0.5051557012878509,0.0723877925216838,0.5490196078431373,0
16,69,1104,125,109,0.6292973754130673,0.07514648665917012,0.2318840579710145,0
56,203,11368,187,131,1.3458319352796055,0.8452453657795014,0.27586206896551724,1
21,74,1554,55,34,0.4340248033367027,0.058241983190658334,0.28378378378378377,0
21,91,1911,66,45,0.46597373903801736,0.18486044777780353,0.23076923076923078,0
16,69,1104,124,108,0.5353963051971079,0.1396302017921096,0.2318840579710145,0
24,107,2568,56,32,0.5751474146952392,0.3081388762292681,0.22429906542056074,0
34,199,6766,132,98,0.8238329076375901,0.4119234445124735,0.1708542713567839,0
10,61,610,120,110,0.5962405030061386,0.16788773119283318,0.16393442622950818,0
12,61,732,151,139,0.5691197516001625,0.006251051590636161,0.19672131147540983,0
12,77,924,187,175,0.7458592770518844,0.12778063508645462,0.15584415584415584,0
0,0,0,0,0,0.0,0.0,0.0,0
14,58,812,181,167,0.5903566175076549,0.0,0.2413793103448276,0
17,109,1853,50,33,0.5422832208228473,0.3244880367542903,0.1559633027522936,0
29,62,1798,176,147,0.5848896687923801,0.47318024951675564,0.46774193548387094,1
13,48,624,123,110,0.5551130449711493,0.0,0.2708333333333333,0
23,78,1794,97,74,0.6797265334311413,0.297060577903751,0.2948717948717949,0
26,173,4498,58,32,0.6370584156889124,0.37072200799819766,0.15028901734104047,0
25,103,2575,55,30,0.6305684248318475,0.44155597787171935,0.24271844660194175,0
19,98,1862,96,77,0.5660017355090274,0.3650655997384804,0.19387755102040816,0
29,113,3277,96,67,0.5520492270915004,0.25187325072369604,0.25663716814159293,0
15,43,645,126,111,0.5460406912474071,0.007283936776407916,0.3488372093023256,0
18,57,1026,49,31,0.5342077855222446,0.18968679016240667,0.3157894736842105,0
11,64,704,153,142,0.877404750141834,0.391481308662176,0.171875,0
10,71,710,154,144,0.7551732936870107,0.1904034311981421,0.14084507042253522,0
10,63,630,121,111,0.8267767309094581,0.1295733602848112,0.15873015873015872,0
12,63,756,74,62,0.5801685992890813,0.3111029209731272,0.19047619047619047,0
30,120,3600,97,67,0.5749814392214249,0.19716889713979643,0.25,0
12,74,888,177,165,0.5700072363907106,0.23922821445440018,0.16216216216216217,0
41,330,13530,187,146,1.287348378283881,1.003589357708077,0.12424242424242424,1
14,59,826,187,173,0.8041930254642027,0.0,0.23728813559322035,0
12,66,792,55,43,0.5594871374685167,0.34125486956190837,0.18181818181818182,0
12,59,708,123,111,0.6523126212226413,0.023359920463959735,0.2033898305084746,0
11,57,627,121,110,0.6813184723145879,0.0,0.19298245614035087,0
24,84,2016,56,32,0.5802785018726059,0.2986968687948679,0.2857142857142857,0
13,60,780,182,169,0.589734111366693,0.0,0.21666666666666667,0
19,134,2546,119,100,0.5223882129007512,0.12253226900411747,0.1417910447761194,0
12,51,612,178,166,0.778460148501379,0.0,0.23529411764705882,0
15,76,1140,124,109,0.5153309528535843,0.0511496431273246,0.19736842105263158,0
15,48,720,49,34,0.4666228355871152,0.30020991540786407,0.3125,0
21,100,2100,54,33,0.47192436888993267,0.1145895503829772,0.21,0
24,44,1056,175,151,0.4363655382431196,0.0,0.5454545454545454,0
34,60,2040,178,144,0.44558212573362793,0.17528653511583037,0.5666666666666667,0
12,52,624,178,166,0.6143053367544233,0.0,0.23076923076923078,0
23,41,943,175,152,0.4055032758430741,0.0,0.5609756097560976,0
17,61,1037,166,149,0.5334631539214749,0.07088812050082956,0.2786885245901639,0
19,102,1938,121,102,0.491641115830942,0.056888721967968535,0.18627450980392157,0
13,63,819,122,109,0.5685408572150366,0.051965925136623986,0.20634920634920634,0
21,84,1764,115,94,0.5243809007517494,0.0017290144133225748,0.25,0
34,439,14926,67,33,0.45634353342307454,0.16930470611101045,0.0774487471526196,0
33,138,4554,174,141,0.4770656989011701,0.013875551838057927,0.2391304347826087,0
35,480,16800,69,34,0.5258680394387674,0.31466196857135714,0.07291666666666667,0
13,51,663,180,167,0.6310279710547675,0.0,0.2549019607843137,0
22,39,858,175,153,0.43973266049698934,0.0,0.5641025641025641,0
13,70,910,120,107,0.6748136403973138,0.07735286335747112,0.18571428571428572,0
13,81,1053,178,165,0.493821340240605,0.0,0.16049382716049382,0
24,92,2208,132,108,1.1315368591525883,0.5818149530247351,0.2608695652173913,0
18,87,1566,52,34,0.45915818920639384,0.13831058984754047,0.20689655172413793,0
13,62,806,177,164,0.5935525807982901,0.0,0.20967741935483872,0
21,36,756,173,152,0.4295659349855837,0.0,0.5833333333333334,0
12,85,1020,155,143,0.4330012598295673,0.10090644448168576,0.1411764705882353,0
16,104,1664,165,149,0.4375254823846833,0.0,0.15384615384615385,0
23,113,2599,55,32,0.5858808251288536,0.36736667581800997,0.20353982300884957,0
98,322,31556,187,89,0.7762991113546527,0.5628884425146926,0.30434782608695654,1
11,62,682,130,119,0.6143806568071368,0.06290472123663868,0.1774193548387097,0
16,47,752,53,37,0.47345596040336707,0.03460862737739523,0.3404255319148936,0
0,0,0,0,0,0.0,0.0,0.0,0
14,85,1190,149,135,0.5926426910454732,0.024144965967387775,0.16470588235294117,0
10,70,700,121,111,0.8648464996849413,0.2243200771507302,0.14285714285714285,0
13,62,806,179,166,0.6518412394922549,0.0,0.20967741935483872,0
24,130,3120,56,32,0.6699300540036486,0.45973823520623874,0.18461538461538463,0
0,0,0,0,0,0.0,0.0,0.0,0
0,0,0,0,0,0.0,0.0,0.0,0
24,130,3120,134,110,0.6939938800229452,0.4495061720759114,0.18461538461538463,0
14,45,630,137,123,0.5272112499713335,0.19554793770673617,0.3111111111111111,0
14,76,1064,96,82,0.5861732025507783,0.3082280548605098,0.18421052631578946,0
20,52,1040,179,159,0.5625634570072946,0.008657196023469874,0.38461538461538464,0
18,88,1584,96,78,0.6035968549224296,0.07484334171301636,0.20454545454545456,0
15,100,1500,52,37,0.6199401774847008,0.33327322941317167,0.15,0
13,73,949,152,139,0.5928307055277792,0.24290107286933627,0.1780821917808219,0
15,105,1575,179,164,0.837095911804932,0.17342189698766838,0.14285714285714285,0
14,100,1400,150,136,0.6088849498786464,0.10485032197247453,0.14,0
13,86,1118,130,117,0.7259976292411026,0.07100124875101256,0.1511627906976744,0
27,141,3807,62,35,0.5369801597128062,0.23512496059507232,0.19148936170212766,0
31,104,3224,173,142,0.542567859694944,0.27367100717437187,0.2980769230769231,0
46,332,15272,187,141,0.500388379841347,0.20319188526053553,0.13855421686746988,1
18,76,1368,110,92,0.6519545830153751,0.2751575728285978,0.23684210526315788,0
48,161,7728,80,32,0.5313274708428067,0.1359211035217952,0.2981366459627329,0
15,69,1035,54,39,0.6175189883202664,0.40785093664741595,0.21739130434782608,0
24,86,2064,56,32,0.6030060876994388,0.21913824903615312,0.27906976744186046,0
18,75,1350,126,108,0.7200807361937301,0.06344762401556472,0.24,0
23,94,2162,55,32,0.6429422770809802,0.32176606976299726,0.24468085106382978,0
13,84,1092,55,42,0.6403840969235938,0.4736342060345387,0.15476190476190477,0
13,48,624,54,41,0.518553392587455,0.15870731925878792,0.2708333333333333,0
0,0,0,0,0,0.0,0.0,0.0,0
0,0,0,0,0,0.0,0.0,0.0,0
25,89,2225,187,162,0.460075683422486,0.0,0.2808988764044944,0
12,85,1020,153,141,0.5886211238683704,0.23694490865289847,0.1411764705882353,0
21,70,1470,55,34,0.5072917878710921,0.18574635268939926,0.3,0
11,56,616,175,164,0.6310599825008614,0.0,0.19642857142857142,0
20,59,1180,156,136,0.49664246638826454,0.2322051428176616,0.3389830508474576,0
25,106,2650,156,131,0.5512317335164229,0.02469532108013627,0.2358490566037736,0
22,89,1958,97,75,0.4925063214959199,0.22134836095157268,0.24719101123595505,0
13,89,1157,164,151,0.552889805186275,0.17349133744063272,0.14606741573033707,0
36,119,4284,187,151,0.5766206559265711,0.24596108237977668,0.3025210084033613,0
33,55,1815,175,142,0.5024240166374315,0.20799191425663763,0.6,0
22,112,2464,56,34,0.5323839359803811,0.26707324037254315,0.19642857142857142,0
14,78,1092,57,43,0.6973651233347263,0.49105921109989087,0.1794871794871795,0
23,62,1426,187,164,0.5582211693343845,0.4204665216860065,0.3709677419354839,1
16,74,1184,61,45,0.5594726826048956,0.3653919978013797,0.21621621621621623,0
24,85,2040,99,75,0.6117480186407525,0.31830035194178863,0.2823529411764706,0
23,85,1955,187,164,0.6806523680153492,0.11516155243560401,0.27058823529411763,0
13,70,910,98,85,0.6117891285064931,0.3169642770898604,0.18571428571428572,0
20,64,1280,64,44,0.4943442190727274,0.15298114517903,0.3125,0
24,56,1344,165,141,0.5194912376734451,0.10461908757377163,0.42857142857142855,0
24,66,1584,98,74,0.5927315248170805,0.35038212488779785,0.36363636363636365,0
22,79,1738,112,90,0.5614970226303977,0.2798363093373033,0.27848101265822783,0
36,80,2880,120,84,0.5711242518469676,0.229107657276553,0.45,0
12,52,624,96,84,0.656251981422971,0.3545411402321766,0.23076923076923078,0
21,118,2478,56,35,0.6484573319341789,0.26661268222476336,0.17796610169491525,0
13,72,936,56,43,0.5852704459266285,0.4398154376886835,0.18055555555555555,0
12,71,852,120,108,0.6967248358036604,0.17957365895828079,0.16901408450704225,0
10,67,670,154,144,0.5459287888591364,0.07630006014504655,0.14925373134328357,0
37,60,2220,185,148,0.5867933732433391,0.3945889739161549,0.6166666666666667,1
29,46,1334,63,34,0.5085382157120952,0.18985775971936836,0.6304347826086957,0
31,162,5022,63,32,0.5928952671293078,0.34247328037539887,0.19135802469135801,0
17,37,629,109,92,0.5618317754663823,0.27636346568297493,0.4594594594594595,0
32,132,4224,109,77,0.5196997220056165,0.20955556678251125,0.24242424242424243,0
38,226,8588,187,149,0.6716680008381883,0.48913039906000944,0.168141592920354,1
69,989,68241,187,118,0.5389587212649964,0.11694302941682223,0.06976744186046512,1
12,68,816,153,141,0.7355825387764283,0.16713755260369653,0.17647058823529413,0
22,83,1826,53,31,0.5881471042116954,0.26825538280309386,0.26506024096385544,0
57,140,7980,187,130,0.6184480346631042,0.3565118059834443,0.40714285714285714,1
23,110,2530,56,33,0.4969081605836484,0.2688811361167516,0.20909090909090908,0
22,146,3212,54,32,0.5807479217424465,0.3439575870766658,0.1506849315068493,0
0,0,0,0,0,0.0,0.0,0.0,0
33,230,7590,65,32,0.5272390540890882,0.27732102770416367,0.14347826086956522,0
28,87,2436,112,84,0.5338045068938632,0.24954673522404516,0.3218390804597701,0
13,49,637,165,152,0.5896093552942607,0.0937395782375434,0.2653061224489796,0
22,120,2640,182,160,0.5914126266362039,0.0,0.18333333333333332,0
11,74,814,123,112,0.5566137759996224,0.0,0.14864864864864866,0
11,58,638,121,110,0.6577203024405672,0.00668562587490634,0.1896551724137931,0
12,61,732,129,117,0.6522931766182558,0.02572862707454255,0.19672131147540983,0
13,61,793,98,85,0.6720708113005078,0.25532578429177755,0.21311475409836064,0
15,81,1215,167,152,0.8077147553539344,0.21323162531329734,0.18518518518518517,0
23,148,3404,56,33,0.6653185948544049,0.4077403606393515,0.1554054054054054,0
11,69,759,123,112,0.5783893775529629,0.19341001090439583,0.15942028985507245,0
21,94,1974,115,94,0.9822186709385983,0.2575048195704046,0.22340425531914893,0
11,62,682,187,176,0.6592764120854109,0.0,0.1774193548387097,0
11,59,649,96,85,0.7270435280125721,0.2835246562786139,0.1864406779661017,0
18,57,1026,109,91,0.7554330317086025,0.34769912297182654,0.3157894736842105,0
11,65,715,123,112,0.8706390388125649,0.16077573042513837,0.16923076923076924,0
19,61,1159,57,38,0.594727627673962,0.35232465048686384,0.3114754098360656,0
16,107,1712,157,141,0.5065157627734481,0.0,0.14953271028037382,0
23,131,3013,56,33,0.6942254066055751,0.4625778214416829,0.17557251908396945,0
36,129,4644,187,151,0.7616460576533497,0.1042918836019715,0.27906976744186046,0
14,56,784,96,82,0.7247537472137114,0.3882889548160333,0.25,0
11,55,605,127,116,0.6970579169770968,0.15673552092841705,0.2,0
21,35,735,55,34,0.47707208595160544,0.30356963936840964,0.6,0
24,70,1680,57,33,0.5729729512689669,0.2557012667408648,0.34285714285714286,0
18,83,1494,81,63,0.5147349574587781,0.14958117379560626,0.21686746987951808,0
18,126,2268,52,34,0.5397506683456255,0.24994184445741957,0.14285714285714285,0
12,54,648,119,107,0.5621302357252221,0.09357995351211394,0.2222222222222222,0
19,111,2109,53,34,0.43559449582850907,0.24532572375045164,0.17117117117117117,0
14,58,812,124,110,0.5716507787442954,0.1201530856443978,0.2413793103448276,0
23,99,2277,187,164,0.7383913209558085,0.005665341076167233,0.23232323232323232,0
18,78,1404,139,121,0.921483721717654,0.09476611156877139,0.23076923076923078,0
16,62,992,67,51,0.6542119270192419,0.2521374774236158,0.25806451612903225,0
17,90,1530,51,34,0.5536350642772904,0.39298267676225745,0.18888888888888888,0
21,67,1407,187,166,0.4598545835540257,0.0,0.31343283582089554,0
13,71,923,80,67,0.5171161785011091,0.10958530500849108,0.18309859154929578,0
14,44,616,149,135,0.44796112806000155,0.016706919736105108,0.3181818181818182,0
18,106,1908,53,35,0.5905079071107469,0.3325315149493627,0.16981132075471697,0
10,64,640,53,43,0.5859636226843014,0.3788370895505709,0.15625,0
22,153,3366,54,32,0.6446225141592481,0.2738472747357996,0.1437908496732026,0
11,66,726,54,43,0.6023593622867542,0.3149765541763351,0.16666666666666666,0
33,242,7986,66,33,0.5067865898153457,0.1830374344657398,0.13636363636363635,0
22,99,2178,55,33,0.4778835953858124,0.23938878830126611,0.2222222222222222,0
19,57,1083,114,95,0.7302595404763741,0.19519371509371683,0.3333333333333333,0
16,47,752,50,34,0.5488826308389387,0.3862765114540908,0.3404255319148936,0
18,107,1926,54,36,0.4540431305665443,0.04645230096320136,0.16822429906542055,0
13,57,741,130,117,0.48291570468593514,0.17282211852280416,0.22807017543859648,0
63,79,4977,187,124,0.725110999088668,0.34905830934500853,0.7974683544303798,1
20,39,780,172,152,0.4243742491001149,0.0,0.5128205128205128,0
12,52,624,187,175,0.5516608899467575,0.0004911530336576105,0.23076923076923078,0
14,64,896,123,109,0.6599098279428549,0.21467260816506673,0.21875,0
15,53,795,124,109,0.6089416969421971,0.38220008789836746,0.2830188679245283,0
11,64,704,186,175,0.7757625984822061,0.10494510691415057,0.171875,0
12,52,624,122,110,0.5402775898879131,0.27877866780555577,0.23076923076923078,0
24,123,2952,187,163,0.5362606714280647,0.0,0.1951219512195122,0
17,60,1020,50,33,0.5312957015840388,0.2974891439775846,0.2833333333333333,0
17,116,1972,53,36,0.45468367654936465,0.1979836901250557,0.14655172413793102,0
22,67,1474,54,32,0.5632384215723966,0.3257601337926613,0.3283582089552239,0
0,0,0,0,0,0.0,0.0,0.0,0
23,41,943,171,148,0.43943079922742884,0.0,0.5609756097560976,0
20,102,2040,54,34,0.4838591471522437,0.1507434937293829,0.19607843137254902,0
22,133,2926,55,33,0.5201986921874302,0.24959852095789656,0.16541353383458646,0
0,0,0,0,0,0.0,0.0,0.0,0
20,51,1020,141,121,0.5734873350201736,0.18161435084592384,0.39215686274509803,0
16,53,848,50,34,0.6554686276721309,0.44112450313997537,0.3018867924528302,0
15,90,1350,187,172,0.965674416232682,0.06959331444001539,0.16666666666666666,0
18,62,1116,156,138,0.6221211459059196,0.18641812431765167,0.2903225806451613,0
16,91,1456,52,36,0.45166440234350946,0.2039739323511686,0.17582417582417584,0
19,90,1710,54,35,0.4827845353218964,0.0,0.2111111111111111,0
17,87,1479,51,34,0.7059396288282617,0.5917108371493217,0.19540229885057472,0
12,69,828,122,110,0.735718149321316,0.0,0.17391304347826086,0
10,64,640,174,164,0.8291663838335753,0.2513445840194953,0.15625,0
17,66,1122,50,33,0.5721400521574256,0.30949943187098516,0.25757575757575757,0
16,87,1392,80,64,0.7055482896372233,0.35863203375252184,0.1839080459770115,0
14,86,1204,178,164,0.6191888079875979,0.0,0.16279069767441862,0
14,53,742,187,173,0.7334359309912469,0.06958997468146515,0.2641509433962264,0
15,69,1035,49,34,0.5127258983319101,0.1980693943759521,0.21739130434782608,0
22,81,1782,187,165,0.5646754065087282,0.0,0.2716049382716049,0
12,52,624,122,110,0.547911803482438,0.08486704852041246,0.23076923076923078,0
24,81,1944,187,163,0.4596413616454341,0.0,0.2962962962962963,0
19,124,2356,53,34,0.5319955092283165,0.15087248585943078,0.1532258064516129,0
34,724,24616,69,35,0.535821757557673,0.27650847060209194,0.04696132596685083,0
35,682,23870,71,36,0.4744940439219859,0.2065474925810037,0.051319648093841645,0
0,0,0,0,0,0.0,0.0,0.0,0
12,52,624,122,110,0.48949273601475474,0.1272845621313902,0.23076923076923078,0
13,47,611,136,123,0.5703619837079478,0.16982501522912027,0.2765957446808511,0
33,182,6006,70,37,0.48312326585487525,0.19480138355449497,0.1813186813186813,0
11,75,825,187,176,0.57009839051077,0.10322015283640931,0.14666666666666667,0
10,68,680,128,118,0.4665511589956663,0.19988302562019478,0.14705882352941177,0
12,56,672,130,118,0.6166420223719866,0.18646180597766973,0.21428571428571427,0
15,75,1125,135,120,0.7272128222378023,0.4345044280379051,0.2,0
40,102,4080,168,128,0.717862790205015,0.5374109204730819,0.39215686274509803,1
14,64,896,130,116,0.6273495280508248,0.0,0.21875,0
20,78,1560,123,103,0.7003273532757424,0.12386754746859885,0.2564102564102564,0
24,100,2400,135,111,0.489113795142443,0.2854551506068233,0.24,0
19,38,722,173,154,0.409254309955592,0.0,0.5,0
22,72,1584,131,109,0.7093516744197039,0.121815293323198,0.3055555555555556,0
183,64,11712,187,4,0.5876674219147562,0.0,2.859375,0
13,48,624,123,110,0.5065757133692896,0.24593181197135303,0.2708333333333333,0
11,70,770,135,124,0.6811618971170919,0.22307473907393294,0.15714285714285714,0
12,63,756,177,165,0.5052052510164006,0.0,0.19047619047619047,0
17,99,1683,52,35,0.5492350522882904,0.11499737390575415,0.1717171717171717,0
19,59,1121,116,97,0.5464509373653267,0.07847542019101941,0.3220338983050847,0
21,125,2625,187,166,0.4423802643737824,0.0,0.168,0
14,61,854,136,122,0.6185348172492642,0.2123450026853041,0.22950819672131148,0
11,56,616,46,35,0.5947232318485182,0.25455824600739557,0.19642857142857142,0
14,46,644,187,173,0.5815136052076129,0.0,0.30434782608695654,0
37,217,8029,187,150,0.7350012938152041,0.4916115822336546,0.17050691244239632,1
18,60,1080,53,35,0.47931971721986144,0.17417268962324278,0.3,0
22,117,2574,54,32,0.5656042915832556,0.20351587651729658,0.18803418803418803,0
15,74,1110,48,33,0.6269445238279513,0.2834201611663519,0.20270270270270271,0
13,60,780,144,131,0.8298836725016018,0.08267149454019125,0.21666666666666667,0
15,64,960,51,36,0.4873560533168025,0.09175997264265412,0.234375,0
16,101,1616,79,63,0.61159084929934,0.40022125240645384,0.15841584158415842,0
17,81,1377,184,167,0.4733399369327149,0.1261565782342829,0.20987654320987653,0
11,66,726,53,42,0.4932064566483595,0.1429667669844588,0.16666666666666666,0
19,33,627,187,168,0.5063150587835347,0.1394664821959318,0.5757575757575758,0
13,70,910,123,110,0.6251114949435679,0.1801281141928823,0.18571428571428572,0
18,93,1674,49,31,0.6421595276182954,0.23615973778859556,0.1935483870967742,0
14,79,1106,186,172,0.4788294258868414,0.045710332902143026,0.17721518987341772,0
11,66,726,177,166,0.5434968899584999,0.18259442862088,0.16666666666666666,0
17,37,629,170,153,0.47321521382676407,0.1538496739906091,0.4594594594594595,0
14,48,672,126,112,0.5228640927581474,0.0707958453816782,0.2916666666666667,0
13,77,1001,158,145,0.6366040315241768,0.15963026605841288,0.16883116883116883,0
21,52,1092,131,110,0.5417190128243118,0.12605041357829747,0.40384615384615385,0
13,69,897,53,40,0.4919493659624232,0.060689241471503584,0.18840579710144928,0
20,52,1040,175,155,0.5156913542842125,0.11003202525584063,0.38461538461538464,0
0,0,0,0,0,0.0,0.0,0.0,0
12,67,804,154,142,0.6174912090573219,0.443071388911697,0.1791044776119403,0
17,42,714,187,170,0.6226643333898486,0.041907679754688426,0.40476190476190477,0
0,0,0,0,0,0.0,0.0,0.0,0
38,49,1862,169,131,0.46018640136622946,0.0,0.7755102040816326,0
25,88,2200,187,162,0.47559988709702916,0.0,0.2840909090909091,0
0,0,0,0,0,0.0,0.0,0.0,0
11,61,671,121,110,0.7526231138741496,0.0030585044456225446,0.18032786885245902,0
10,66,660,158,148,0.7330624129015507,0.17761591679312547,0.15151515151515152,0
11,78,858,187,176,0.7064898025392993,0.06414391598775201,0.14102564102564102,0
11,60,660,121,110,0.5958789805837177,0.0,0.18333333333333332,0
19,103,1957,54,35,0.4609684491253506,0.18587832445947838,0.18446601941747573,0
35,856,29960,68,33,0.5510798901713618,0.29467578387770355,0.04088785046728972,0
0,0,0,0,0,0.0,0.0,0.0,0
27,134,3618,67,40,0.5725590744384528,0.4006871388327353,0.20149253731343283,0
38,882,33516,75,37,0.44070109487135756,0.0932776132975065,0.04308390022675737,0
13,83,1079,166,153,0.9797720055594301,0.47268170784285735,0.1566265060240964,0
45,801,36045,80,35,0.5063703456790043,0.295656277949744,0.056179775280898875,0
31,558,17298,82,51,0.5956301599574438,0.2888710417535961,0.05555555555555555,0
15,79,1185,178,163,0.8123253805060844,0.0,0.189873417721519,0
0,0,0,0,0,0.0,0.0,0.0,0
11,77,847,134,123,0.7857775950269336,0.31884669345726135,0.14285714285714285,0
22,67,1474,187,165,0.5074923652169776,0.0,0.3283582089552239,0
10,66,660,178,168,0.5862174942344178,0.0,0.15151515151515152,0
18,80,1440,187,169,0.4361420829623448,0.1321452715817884,0.225,0
13,67,871,154,141,0.7208780614041496,0.12647004122072322,0.19402985074626866,0
26,45,1170,175,149,0.4457017237506418,0.0,0.5777777777777777,0
12,63,756,55,43,0.5048719930619131,0.07287496898343884,0.19047619047619047,0
12,76,912,182,170,0.5538264367504384,0.0,0.15789473684210525,0
13,61,793,146,133,0.37497766527483284,0.024064007946887754,0.21311475409836064,0
11,76,836,187,176,0.6849282323482191,0.12707449104407903,0.14473684210526316,0
14,91,1274,130,116,0.8244627518103728,0.5463147583379349,0.15384615384615385,0
17,93,1581,50,33,0.5169207611081373,0.17235301710092435,0.1827956989247312,0
15,98,1470,124,109,0.6056646311800123,0.03978464339436424,0.15306122448979592,0
22,88,1936,55,33,0.6136458359176572,0.2877226866933189,0.25,0
22,100,2200,187,165,0.4686031034776114,0.0,0.22,0
35,104,3640,67,32,0.6254801039030089,0.2203312721058328,0.33653846153846156,0
16,44,704,183,167,0.5016646647540765,0.0,0.36363636363636365,0
11,55,605,121,110,0.6698350504265171,0.06334638306917656,0.2,0
12,78,936,122,110,0.5667300497809846,0.013126411582804209,0.15384615384615385,0
18,38,684,111,93,0.6135442618518626,0.2535224376759344,0.47368421052631576,0
14,43,602,55,41,0.5694418977173417,0.45038035462599824,0.32558139534883723,0
13,91,1183,81,68,0.6404622452415607,0.49282747975557967,0.14285714285714285,0
21,57,1197,96,75,0.593065044808824,0.38244759116638744,0.3684210526315789,0
20,69,1380,52,32,0.5696388643082303,0.31422634374684305,0.2898550724637681,0
13,51,663,187,174,0.7297336532091894,0.20432882533960456,0.2549019607843137,0
15,66,990,95,80,0.5856903431747709,0.3759927323501887,0.22727272727272727,0
38,169,6422,69,31,0.5167329408410296,0.15123817253426514,0.22485207100591717,0
12,67,804,178,166,0.5947337610906417,0.05977024260336327,0.1791044776119403,0
13,87,1131,58,45,0.587833748347996,0.2663925378454645,0.14942528735632185,0
13,60,780,128,115,0.9099207442306516,0.2146206357354728,0.21666666666666667,0
18,58,1044,128,110,0.6151361841587911,0.20355245388610027,0.3103448275862069,0
11,60,660,129,118,0.6807603903689535,0.19351358860877446,0.18333333333333332,0
12,66,792,54,42,0.6279763168992072,0.2628297300091651,0.18181818181818182,0
0,0,0,0,0,0.0,0.0,0.0,0
13,56,728,159,146,0.5574219548189202,0.0,0.23214285714285715,0
20,36,720,171,151,0.43685163093472784,0.0,0.5555555555555556,0
12,62,744,155,143,0.47798244147877816,0.2733211101415245,0.1935483870967742,0
17,81,1377,50,33,0.5476703748569234,0.2320057166980962,0.20987654320987653,0
11,67,737,120,109,0.47510052033674927,0.0,0.16417910447761194,0
22,132,2904,55,33,0.46011767312924784,0.19229011994831666,0.16666666666666666,0
20,94,1880,109,89,0.5124383351230657,0.22430376369747998,0.2127659574468085,0
21,62,1302,54,33,0.4579098559198221,0.13500829292723598,0.3387096774193548,0
12,81,972,177,165,0.6448136238862974,0.0,0.14814814814814814,0
12,63,756,66,54,0.5702809352094141,0.32268852768010386,0.19047619047619047,0
16,44,704,109,93,0.5415206955991999,0.34363358603102384,0.36363636363636365,0
14,49,686,55,41,0.49184148545058853,0.07385691506873324,0.2857142857142857,0
14,49,686,152,138,0.5219258940368899,0.0,0.2857142857142857,0
12,62,744,187,175,0.785424270909792,0.12489991901488104,0.1935483870967742,0
19,130,2470,51,32,0.6302947458251978,0.3461052718021752,0.14615384615384616,0
15,61,915,123,108,0.5216071514341313,0.2006079159712423,0.2459016393442623,0
15,98,1470,100,85,0.5827988681233509,0.3265860417789657,0.15306122448979592,0
45,549,24705,79,34,0.5057157598457364,0.1408759823806941,0.08196721311475409,0
31,74,2294,135,104,0.4619592218080675,0.022633569440773046,0.4189189189189189,0
13,77,1001,97,84,0.7529419006806104,0.6081222684759529,0.16883116883116883,0
11,71,781,121,110,0.5830421794450115,0.18354157504385685,0.15492957746478872,0
19,87,1653,93,74,0.6176180436093578,0.38617050593495206,0.21839080459770116,0
10,65,650,120,110,0.7008388216670098,0.02468466963960706,0.15384615384615385,0
10,63,630,120,110,0.6707070298538125,0.15388948032487568,0.15873015873015872,0
22,87,1914,108,86,0.6542675680826628,0.36490910211455485,0.25287356321839083,0
23,145,3335,97,74,0.5147303791222211,0.2822020236827764,0.15862068965517243,0
19,78,1482,61,42,0.5802066156336515,0.3764185995658533,0.24358974358974358,0
24,149,3576,64,40,0.5424247702304558,0.2780779365484769,0.1610738255033557,0
12,60,720,97,85,0.61523543611231,0.23736343875492863,0.2,0
11,74,814,98,87,0.619251016760725,0.41909077457488353,0.14864864864864866,0
26,116,3016,114,88,0.6209873515864628,0.1972788330404146,0.22413793103448276,0
14,89,1246,57,43,0.6014663233293371,0.3643038131169839,0.15730337078651685,0
19,100,1900,109,90,0.6150617294874664,0.30035732229902623,0.19,0
23,68,1564,160,137,0.6383540235183931,0.12428152310370628,0.3382352941176471,0
15,100,1500,106,91,0.6652741040428524,0.3738062728270233,0.15,0
25,150,3750,58,33,0.5400047862206256,0.3603129698488113,0.16666666666666666,0
25,55,1375,67,42,0.5267377060718731,0.18377396150132574,0.45454545454545453,0
22,137,3014,96,74,0.5706724450144749,0.3240623329671375,0.16058394160583941,0
12,61,732,80,68,0.5945180825331601,0.39918125591243525,0.19672131147540983,0
14,97,1358,123,109,0.7586798151933722,0.04388671408253319,0.14432989690721648,0
21,83,1743,124,103,0.6042568050449837,0.10831068392773464,0.25301204819277107,0
32,336,10752,64,32,0.5849597928430924,0.24972579201440032,0.09523809523809523,0
15,82,1230,125,110,0.6251366397173651,0.0,0.18292682926829268,0
16,69,1104,125,109,0.6851708452561233,0.13077895536212406,0.2318840579710145,0
18,71,1278,109,91,0.65212350508273,0.42610157490973816,0.2535211267605634,0
26,137,3562,66,40,0.5774310733343797,0.25543755739935825,0.1897810218978102,0
27,140,3780,57,30,0.5783293584834228,0.37834605073574923,0.19285714285714287,0
27,119,3213,96,69,0.5759025427770547,0.17951481833575697,0.226890756302521,0
21,141,2961,84,63,0.6214356097879218,0.1716922754835662,0.14893617021276595,0
11,76,836,96,85,0.7000380052858227,0.30124908473292594,0.14473684210526316,0
16,96,1536,98,82,0.5308560598438816,0.25374039235768586,0.16666666666666666,0
15,86,1290,99,84,0.5870857876431184,0.23178249052396155,0.1744186046511628,0
16,59,944,157,141,0.7554018859834476,0.29152016687837407,0.2711864406779661,0
16,102,1632,98,82,0.5865679289328072,0.2001397363686177,0.1568627450980392,0
19,55,1045,157,138,0.6536036079716787,0.0,0.34545454545454546,0
15,84,1260,179,164,0.5987495390026019,0.015282510074648316,0.17857142857142858,0
13,49,637,96,83,0.5299335373219033,0.2873422434085795,0.2653061224489796,0
20,136,2720,67,47,0.5836067036927371,0.28790203600356573,0.14705882352941177,0
13,53,689,123,110,0.7766353718325179,0.20174640748489764,0.24528301886792453,0
16,104,1664,107,91,0.6488949964173446,0.32235963604527895,0.15384615384615385,0
13,60,780,130,117,0.5476898770659884,0.15803502970929212,0.21666666666666667,0
17,73,1241,96,79,0.5640033975299721,0.33748193689340983,0.2328767123287671,0
18,74,1332,66,48,0.5330179872437655,0.3259006217889759,0.24324324324324326,0
16,70,1120,94,78,0.5823257256762274,0.3961322883120711,0.22857142857142856,0
11,58,638,145,134,0.7062661500493934,0.0765421126588636,0.1896551724137931,0
18,126,2268,96,78,0.5367069722278378,0.38240765199281845,0.14285714285714285,0
25,107,2675,96,71,0.5665981086133074,0.358786127069689,0.2336448598130841,0
30,94,2820,96,66,0.6275322769416607,0.4062130420804157,0.3191489361702128,0
12,76,912,128,116,0.5894197200926774,0.0,0.15789473684210525,0
19,46,874,172,153,0.533761279622342,0.03963345668035904,0.41304347826086957,0
19,77,1463,127,108,0.6858617035786044,0.3030964937218595,0.24675324675324675,0
12,71,852,115,103,0.6948611302472729,0.4290115746563846,0.16901408450704225,0
23,64,1472,55,32,0.5252481705713392,0.33081235624776745,0.359375,0
29,96,2784,69,40,0.597137933041946,0.3417446179221035,0.3020833333333333,0
14,69,966,56,42,0.5162076505152743,0.32098774365877025,0.2028985507246377,0
13,59,767,130,117,0.5988000671555813,0.38717925176618817,0.22033898305084745,0
0,0,0,0,0,0.0,0.0,0.0,0
13,85,1105,68,55,0.5701215991780073,0.37393482653671584,0.15294117647058825,0
25,80,2000,66,41,0.5422910349765857,0.2607140054509432,0.3125,0
10,64,640,121,111,0.5229249569574961,0.19969379804518822,0.15625,0
15,103,1545,48,33,0.6023901558728043,0.3097400118889675,0.14563106796116504,0
12,51,612,121,109,0.5701024183465121,0.10118109969338868,0.23529411764705882,0
11,63,693,187,176,0.8760181601686533,0.11358023424516207,0.1746031746031746,0
117,122,14274,187,70,0.3717762708130642,0.0,0.9590163934426229,0
15,77,1155,55,40,0.4142715412070574,0.13379689385766325,0.19480519480519481,0
25,150,3750,68,43,0.49183712657712997,0.21569721813213202,0.16666666666666666,0
12,53,636,121,109,0.45864573928122937,0.13563828838410502,0.22641509433962265,0
25,141,3525,65,40,0.4647824690690761,0.149584291514741,0.1773049645390071,0
18,111,1998,109,91,0.4789707909828975,0.22287111666629536,0.16216216216216217,0
33,138,4554,66,33,0.47953163361411455,0.178812479755417,0.2391304347826087,0
14,58,812,123,109,0.46223831730097836,0.013873583341004973,0.2413793103448276,0
24,120,2880,56,32,0.5553386598864973,0.3298333144454061,0.2,0
10,62,620,155,145,0.772654597347865,0.2622320593514367,0.16129032258064516,0
34,345,11730,66,32,0.5318148334616892,0.19155463991323884,0.09855072463768116,0
25,60,1500,177,152,0.7226123578418654,0.12222935957677472,0.4166666666666667,0
15,54,810,57,42,0.5790639435600597,0.3875009712135004,0.2777777777777778,0
23,41,943,155,132,0.5068805014232194,0.07434040490408364,0.5609756097560976,0
15,77,1155,180,165,0.5358291791937995,0.0,0.19480519480519481,0
21,70,1470,53,32,0.5021042122151539,0.3154418832670848,0.3,0
24,62,1488,56,32,0.5512641185124343,0.27591598539168855,0.3870967741935484,0
21,64,1344,52,31,0.49630849006956407,0.22710630057589315,0.328125,0
21,37,777,172,151,0.4656978997111875,0.012517003316745434,0.5675675675675675,0
14,45,630,125,111,0.4634921230593352,0.0,0.3111111111111111,0
11,72,792,126,115,0.9391924266380791,0.3610687275699156,0.1527777777777778,0
24,144,3456,56,32,0.5829762275817667,0.22657661101040225,0.16666666666666666,0
14,72,1008,179,165,0.5960370427889887,0.21078578457463065,0.19444444444444445,0
10,63,630,86,76,0.6213828844168154,0.3465162429415086,0.15873015873015872,0
11,56,616,128,117,0.6317583036748642,0.2854862610815722,0.19642857142857142,0
19,98,1862,57,38,0.6448174316260421,0.3520698570302291,0.19387755102040816,0
23,145,3335,54,31,0.5881699969772749,0.15586533659566804,0.15862068965517243,0
12,80,960,122,110,0.5884731986832209,0.19902817751143811,0.15,0
11,74,814,56,45,0.5478893577448829,0.3273031726859572,0.14864864864864866,0
13,51,663,180,167,0.5043962776753512,0.0,0.2549019607843137,0
14,50,700,153,139,0.462904215304275,0.29650769345335376,0.28,0
16,63,1008,153,137,0.673267758268059,0.1028507008826746,0.25396825396825395,0
18,90,1620,126,108,0.6981657598484293,0.11213836297346182,0.2,0
13,55,715,55,42,0.5655376086358509,0.3715958534134252,0.23636363636363636,0
17,82,1394,55,38,0.4997671328924319,0.2877720528826406,0.2073170731707317,0
13,85,1105,129,116,0.6168322556912117,0.17647011306360794,0.15294117647058825,0
13,66,858,153,140,0.7954796927080054,0.11988915377546652,0.19696969696969696,0
13,75,975,158,145,1.0756734813942173,0.41718248922973733,0.17333333333333334,0
18,94,1692,50,32,0.6077745940233888,0.4361961755089115,0.19148936170212766,0
19,99,1881,166,147,0.5723934081377015,0.0,0.1919191919191919,0
12,76,912,159,147,0.7357897688886158,0.1028204201935317,0.15789473684210525,0
65,118,7670,130,65,0.5567847890438447,0.15626863634454663,0.5508474576271186,0
18,109,1962,50,32,0.5644750335476477,0.2787245448804134,0.1651376146788991,0
15,48,720,125,110,0.5725340580370579,0.36402155097607103,0.3125,0
18,38,684,170,152,0.45329643333684,0.0015249585264464317,0.47368421052631576,0
19,76,1444,50,31,0.5877816193294022,0.2885759535499981,0.25,0
20,35,700,171,151,0.4390582610071317,0.0,0.5714285714285714,0
19,54,1026,126,107,0.5568132118182695,0.2293286085207217,0.35185185185185186,0
99,228,22572,166,67,0.49928278433018114,0.045911323041925654,0.4342105263157895,0
22,55,1210,66,44,0.43929020120829326,0.03839548301384285,0.4,0
19,127,2413,123,104,0.5225597843678311,0.07741062775842686,0.14960629921259844,0
15,58,870,164,149,0.5073985357173765,0.05436288723677249,0.25862068965517243,0
21,91,1911,115,94,0.5451546246135578,0.058370630271511174,0.23076923076923078,0
25,145,3625,68,43,0.49616392979498497,0.240959423922077,0.1724137931034483,0
13,67,871,56,43,0.49347804524495753,0.30990504768086696,0.19402985074626866,0
13,49,637,46,33,0.4815802976218418,0.2063332148962739,0.2653061224489796,0
23,105,2415,164,141,0.66311964252433,0.15734717343948182,0.21904761904761905,0
16,97,1552,62,46,0.5587787812365369,0.1530224347213356,0.16494845360824742,0
17,60,1020,124,107,0.5839618869694871,0.04286504380146921,0.2833333333333333,0
12,52,624,122,110,0.6191832723734569,0.0,0.23076923076923078,0
0,0,0,0,0,0.0,0.0,0.0,0
13,67,871,157,144,0.6616566197438883,0.42061237269905083,0.19402985074626866,0
21,67,1407,108,87,0.5354578495189432,0.3807473206427051,0.31343283582089554,0
23,36,828,56,33,0.5583710168974269,0.3395229724152909,0.6388888888888888,0
19,38,722,170,151,0.4648716570155336,0.0,0.5,0
21,149,3129,111,90,0.6533115232503512,0.448389104508521,0.14093959731543623,0
11,78,858,100,89,0.5448915016717629,0.4871041936617098,0.14102564102564102,0
13,70,910,82,69,0.5937312379661774,0.4470815636859315,0.18571428571428572,0
13,53,689,81,68,0.5091218420860801,0.381433763692816,0.24528301886792453,0
21,55,1155,96,75,0.5682195975964073,0.21107635386582616,0.38181818181818183,0
29,183,5307,97,68,0.5854177129233806,0.3330701708408684,0.15846994535519127,0
11,73,803,104,93,0.5970717776526752,0.09019998821555912,0.1506849315068493,0
22,65,1430,99,77,0.5658783286855876,0.3616694402333757,0.3384615384615385,0
26,90,2340,97,71,0.5268295329476561,0.2028004689145051,0.28888888888888886,0
25,132,3300,97,72,0.5653315534947618,0.2908545785496335,0.1893939393939394,0
18,123,2214,110,92,0.6084119514185565,0.268861844196185,0.14634146341463414,0
24,51,1224,97,73,0.5765722576406043,0.34090612409953186,0.47058823529411764,0
11,78,858,135,124,0.6058162446315272,0.10088201225722293,0.14102564102564102,0
14,52,728,84,70,0.6169945044698802,0.4062099444985715,0.2692307692307692,0
11,62,682,128,117,0.7599409771616304,0.1444699815494469,0.1774193548387097,0
18,103,1854,61,43,0.6850689466620395,0.467788526398806,0.17475728155339806,0
11,76,836,119,108,1.0455005478871189,0.19200614429493584,0.14473684210526316,0
21,33,693,177,156,0.44368467252314714,0.01822525835005107,0.6363636363636364,0
20,93,1860,129,109,0.6858307249819039,0.4674473442446948,0.21505376344086022,0
11,74,814,128,117,0.629930947013784,0.26838500523129133,0.14864864864864866,0
39,106,4134,61,22,0.5338247712489441,0.21280563525041984,0.36792452830188677,0
10,68,680,187,177,0.7903536066373112,0.06078523009682901,0.14705882352941177,0
23,131,3013,97,74,0.5046494556788009,0.07292352011905953,0.17557251908396945,0
12,57,684,128,116,0.781706301951325,0.2820792659864146,0.21052631578947367,0
21,50,1050,130,109,0.6314736504235466,0.006522516270407068,0.42,0
20,34,680,173,153,0.48331499297980507,0.08799301027067022,0.5882352941176471,0
28,182,5096,59,31,0.5228068101780746,0.2830239449978006,0.15384615384615385,0
11,67,737,122,111,0.7241183772556661,0.044518531891918484,0.16417910447761194,0
17,89,1513,62,45,0.5905161998348856,0.27475330724855734,0.19101123595505617,0
25,80,2000,56,31,0.5914585989345318,0.21317387872434104,0.3125,0
22,102,2244,187,165,0.5715360620560577,0.03531418567687715,0.21568627450980393,0
21,110,2310,187,166,0.5257479051799779,0.0,0.19090909090909092,0
21,73,1533,187,166,0.6944467498044504,0.0,0.2876712328767123,0
17,85,1445,49,32,0.6679226973545253,0.4351099600941212,0.2,0
11,67,737,67,56,0.49980325668187403,0.2533774985424666,0.16417910447761194,0
14,73,1022,187,173,0.5814850279194909,0.0,0.1917808219178082,0
16,104,1664,181,165,0.8428535676686676,0.0,0.15384615384615385,0
10,68,680,66,56,0.5067055574177783,0.32011707928931254,0.14705882352941177,0
31,178,5518,67,36,0.5542190153064894,0.27782208916175355,0.17415730337078653,0
12,73,876,78,66,0.7666920559774499,0.29459699862808136,0.1643835616438356,0
12,75,900,54,42,0.69140856890295,0.4556910692829975,0.16,0
17,120,2040,123,106,0.48455279507840787,0.0,0.14166666666666666,0
18,127,2286,81,63,0.45682063816971236,0.12227093631808396,0.14173228346456693,0
38,366,13908,66,28,0.4006483496458345,0.04656840814081411,0.10382513661202186,0
11,72,792,150,139,0.562730088631713,0.15253993587304318,0.1527777777777778,0
13,87,1131,122,109,0.4595335555309687,0.0,0.14942528735632185,0
22,41,902,174,152,0.4346337446158155,0.0,0.5365853658536586,0
11,59,649,153,142,0.6706281557829129,0.004555991369641854,0.1864406779661017,0
13,67,871,178,165,0.5414554548821674,0.0,0.19402985074626866,0
14,74,1036,123,109,0.5697490643133929,0.15602559971091146,0.1891891891891892,0
16,95,1520,152,136,0.5126412977565259,0.25079453641145266,0.16842105263157894,0
23,124,2852,97,74,0.6065674444983069,0.3031294850597438,0.18548387096774194,0
23,144,3312,55,32,0.6522385182210624,0.21123193181943573,0.1597222222222222,0
16,79,1264,169,153,0.49807926851072465,0.09669973624488991,0.20253164556962025,0
18,41,738,171,153,0.4736288751765376,0.023984504221194854,0.43902439024390244,0
13,48,624,115,102,0.5788371033371005,0.058293852393920896,0.2708333333333333,0
11,56,616,129,118,0.5642225751033612,0.0,0.19642857142857142,0
18,71,1278,129,111,0.5177060052327396,0.0540622159981282,0.2535211267605634,0
23,102,2346,97,74,0.650126704205206,0.42190958511500953,0.22549019607843138,0
23,120,2760,97,74,0.5819904177975399,0.14242995534173547,0.19166666666666668,0
12,60,720,125,113,0.6634622110186763,0.10411471393073239,0.2,0
20,63,1260,54,34,0.5328988337494215,0.2918451247441605,0.31746031746031744,0
24,153,3672,56,32,0.6545747502490327,0.44452125631791095,0.1568627450980392,0
22,93,2046,54,32,0.6155357141489384,0.2758450186370631,0.23655913978494625,0
23,71,1633,187,164,0.5724555746939345,0.0,0.323943661971831,0
19,84,1596,62,43,0.4849156579448602,0.19817664619212824,0.2261904761904762,0
10,67,670,157,147,0.7105046402456088,0.22826889314323875,0.14925373134328357,0
16,75,1200,140,124,0.7668860716619141,0.1406517071703842,0.21333333333333335,0
18,65,1170,125,107,0.8491906861491663,0.46633290594254334,0.27692307692307694,0
23,115,2645,56,33,0.5228228411357471,0.3146568775622927,0.2,0
21,124,2604,96,75,0.649233178684802,0.37450059683102244,0.1693548387096774,0
28,97,2716,138,110,0.5276257764472043,0.22231539116741988,0.28865979381443296,0
12,58,696,96,84,0.7145031901330454,0.1220411957835494,0.20689655172413793,0
13,56,728,95,82,0.6321037649222248,0.2520429522957867,0.23214285714285715,0
13,59,767,58,45,0.6458110992695039,0.3470349561983773,0.22033898305084745,0
35,106,3710,187,152,0.6000191888802314,0.11245549547527793,0.330188679245283,0
15,47,705,97,82,0.5866629485817837,0.48622944758760783,0.3191489361702128,0
14,91,1274,96,82,0.5658132711223165,0.44631327625697564,0.15384615384615385,0
16,112,1792,97,81,0.8094203598291065,0.5209464396309322,0.14285714285714285,0
15,56,840,98,83,0.6268110614840833,0.3544943378633744,0.26785714285714285,0
22,118,2596,130,108,0.86155594240214,0.48160597343247885,0.1864406779661017,0
16,60,960,97,81,0.5802697193887968,0.4809564185922047,0.26666666666666666,0
14,52,728,187,173,0.6843751219604255,0.17889635958073247,0.2692307692307692,0
15,83,1245,97,82,0.7029191221259572,0.5954685773947752,0.18072289156626506,0
14,54,756,155,141,0.5954971482389896,0.06500413906720261,0.25925925925925924,0
15,54,810,96,81,0.6903445482031564,0.5514662640482698,0.2777777777777778,0
13,84,1092,124,111,0.7745963898773834,0.24351228339891462,0.15476190476190477,0
17,65,1105,96,79,0.6327650343916046,0.27002149816534865,0.26153846153846155,0
15,67,1005,96,81,0.7020852387595953,0.4096500264848501,0.22388059701492538,0
22,50,1100,139,117,0.5091981073244032,0.14019680397288023,0.44,0
12,84,1008,122,110,0.9265407891587725,0.24529545079490983,0.14285714285714285,0
20,93,1860,121,101,0.479773615780006,0.014432587470252615,0.21505376344086022,0
11,60,660,121,110,0.6107297225983084,0.27297010284158113,0.18333333333333332,0
20,93,1860,154,134,0.6991034697416267,0.12786380264244762,0.21505376344086022,0
16,43,688,79,63,0.49462333810545234,0.0,0.37209302325581395,0
14,56,784,149,135,0.48467847379390444,0.06436232928340223,0.25,0
17,113,1921,179,162,0.7820061664394462,0.004618172589840446,0.1504424778761062,0
10,67,670,120,110,0.6773618595370459,0.1836826974135142,0.14925373134328357,0
17,46,782,54,37,0.4341980036691829,0.06175780991847402,0.3695652173913043,0
18,122,2196,125,107,0.5768777216405404,0.41183943881755625,0.14754098360655737,0
11,78,858,121,110,0.7451257559867872,0.02616965688654679,0.14102564102564102,0
15,82,1230,123,108,0.5194682565543001,0.22852066543802385,0.18292682926829268,0
14,51,714,156,142,0.7090507776644219,0.232571367313624,0.27450980392156865,0
31,75,2325,187,156,0.7134294220599086,0.09926590869912287,0.41333333333333333,0
36,275,9900,69,33,0.6240394392395532,0.45209794507241235,0.13090909090909092,0
14,54,756,106,92,0.5606692558381541,0.19671038559469103,0.25925925925925924,0
21,92,1932,130,109,0.5293326899776648,0.20053357291137783,0.22826086956521738,0
15,45,675,146,131,0.5210380951098617,0.11490946493968356,0.3333333333333333,0
33,782,25806,67,34,0.6092675808079769,0.41487200884973047,0.04219948849104859,0
29,70,2030,121,92,0.5120328223925629,0.013087666635030379,0.4142857142857143,0
14,80,1120,124,110,0.6884898548351042,0.0,0.175,0
13,52,676,80,67,0.5270933943362925,0.40821793980589155,0.25,0
13,81,1053,122,109,0.5638355672654591,0.01147253964587481,0.16049382716049382,0
11,58,638,55,44,0.538777320842212,0.2645627299305903,0.1896551724137931,0
15,103,1545,64,49,0.5540453027192546,0.39800872522551695,0.14563106796116504,0
11,68,748,153,142,0.5754435515251135,0.3123693019399313,0.16176470588235295,0
11,77,847,158,147,0.5336105410556915,0.24268772208818296,0.14285714285714285,0
15,52,780,107,92,0.5663090293045505,0.30529511741964976,0.28846153846153844,0
21,35,735,170,149,0.4549778696239822,0.01255989824652478,0.6,0
22,63,1386,131,109,0.6445839089819755,0.2458347713467112,0.3492063492063492,0
57,76,4332,125,68,0.5385967041614063,0.14140667810517465,0.75,0
22,136,2992,63,41,0.5510132145633588,0.30703412670846875,0.16176470588235295,0
12,54,648,87,75,0.5928577167396755,0.3970018546443328,0.2222222222222222,0
19,81,1539,97,78,0.5477676068245032,0.3121804237594666,0.2345679012345679,0
23,37,851,186,163,0.527099776214533,0.2730857957139622,0.6216216216216216,0
25,159,3975,57,32,0.5554118797658729,0.29416936473809935,0.15723270440251572,0
11,61,671,186,175,0.604588404308399,0.1702822138980749,0.18032786885245902,0
16,71,1136,95,79,0.6130867141342667,0.11249647237614681,0.22535211267605634,0
30,93,2790,123,93,0.6780525419389299,0.25002901115211884,0.3225806451612903,0
18,47,846,126,108,0.5684121008810732,0.2770875521201888,0.3829787234042553,0
14,59,826,140,126,0.4814071856974159,0.09698950210837252,0.23728813559322035,0
23,65,1495,106,83,0.5616610691578374,0.2750438561520943,0.35384615384615387,0
14,52,728,179,165,0.7211657521577168,0.008386204969227233,0.2692307692307692,0
18,121,2178,98,80,0.6108832302736636,0.3730642816419722,0.1487603305785124,0
15,59,885,98,83,0.6751368896249808,0.09172385685556189,0.2542372881355932,0
14,58,812,95,81,0.6365309272037201,0.25063740277516977,0.2413793103448276,0
18,119,2142,100,82,0.5737775267297687,0.08680478481160113,0.15126050420168066,0
30,153,4590,97,67,0.6381113985673298,0.1167737737678043,0.19607843137254902,0
11,77,847,183,172,0.692806089347075,0.0,0.14285714285714285,0
13,86,1118,132,119,0.6722557868464436,0.16725672491679278,0.1511627906976744,0
0,0,0,0,0,0.0,0.0,0.0,0
10,65,650,96,86,0.6366922512966827,0.2815317267038135,0.15384615384615385,0
32,172,5504,97,65,0.5746362171408883,0.0637170129338734,0.18604651162790697,0
65,1092,70980,97,32,0.6925080580241089,0.4815765514723522,0.05952380952380952,0
24,67,1608,105,81,0.6746001555641873,0.5544714940581271,0.3582089552238806,0
66,170,11220,97,31,0.9042937782992299,0.6647803920111497,0.38823529411764707,0
20,136,2720,97,77,0.7876508672786066,0.5606520247329648,0.14705882352941177,0
64,190,12160,96,32,0.7091359000436341,0.5420795268530315,0.3368421052631579,0
67,138,9246,98,31,0.7936120026274055,0.5664072366835153,0.4855072463768116,0
19,82,1558,105,86,0.8027771708003273,0.6210618983209725,0.23170731707317074,0
33,654,21582,133,100,0.5704550065338329,0.4307545930646307,0.05045871559633028,0
47,362,17014,130,83,0.5793398068884407,0.42254107340303554,0.1298342541436464,0
63,315,19845,95,32,0.5370084918158522,0.25551376590008945,0.2,0
30,113,3390,106,76,0.8713088034400867,0.6026570889350688,0.26548672566371684,0
45,1099,49455,133,88,0.6546861477836438,0.5048632946692004,0.04094631483166515,0
22,77,1694,106,84,0.8161325082078452,0.43104498335038527,0.2857142857142857,0
17,114,1938,105,88,0.7863754750276828,0.54905997176129,0.14912280701754385,0
68,85,5780,100,32,0.5693363816503265,0.312766630029899,0.8,0
10,71,710,96,86,1.0293937597726497,0.7143724170376615,0.14084507042253522,0
28,87,2436,112,84,0.7761648389632326,0.4692416854061505,0.3218390804597701,0
26,74,1924,107,81,1.177739440392861,0.5246591275355627,0.35135135135135137,0
25,68,1700,108,83,0.914611930692815,0.5222545827671249,0.36764705882352944,0
42,56,2352,122,80,0.7548295319092488,0.5764022385513913,0.75,0
21,78,1638,106,85,0.6404115718089772,0.4588684852236387,0.2692307692307692,0
33,581,19173,67,34,0.8031226674423131,0.7166625869179344,0.05679862306368331,0
10,70,700,95,85,0.6797082925431001,0.5148769945292108,0.14285714285714285,0
17,80,1360,52,35,0.7414211415825267,0.5766556823807365,0.2125,0
31,334,10354,65,34,0.7734127510803478,0.6339902236094073,0.09281437125748503,0
11,76,836,98,87,0.6362262236622984,0.5485134745019741,0.14473684210526316,0
18,44,792,102,84,0.6403561219627453,0.565344734776479,0.4090909090909091,0
17,113,1921,98,81,0.6564702810619906,0.433663246530235,0.1504424778761062,0
12,79,948,98,86,0.68908139611353,0.6718556428436233,0.1518987341772152,0
18,112,2016,132,114,0.5934510866629712,0.43867968102358806,0.16071428571428573,0
23,83,1909,106,83,0.8157856280473338,0.6801822709841547,0.27710843373493976,0
12,66,792,133,121,0.5993949900985241,0.5599714324471121,0.18181818181818182,0
16,72,1152,134,118,0.6763247947799479,0.5131515031048381,0.2222222222222222,0
27,75,2025,105,78,0.8120950857379696,0.3571400750396461,0.36,0
30,187,5610,106,76,0.6975582901291183,0.6152245798687517,0.16042780748663102,0
14,82,1148,101,87,0.5921057865103809,0.4536518924259862,0.17073170731707318,0
32,194,6208,72,40,0.5788590579542942,0.3226792814915214,0.16494845360824742,0
11,69,759,131,120,0.5430733982044045,0.5056336590090538,0.15942028985507245,0
12,77,924,132,120,0.5360964965634502,0.3189070707390066,0.15584415584415584,0
22,62,1364,102,80,0.5758562676533276,0.5123102580575423,0.3548387096774194,0
12,75,900,132,120,0.5361852476816243,0.40231105081358837,0.16,0
19,112,2128,105,86,0.5395009665115282,0.3456169084928434,0.16964285714285715,0
11,57,627,130,119,0.5254327465077396,0.282838003885827,0.19298245614035087,0
18,48,864,131,113,0.5425046833169835,0.13046459008284866,0.375,0
12,64,768,99,87,0.604594759302352,0.36143791492618715,0.1875,0
29,92,2668,105,76,0.5215321207416842,0.3669467403226157,0.31521739130434784,0
16,50,800,86,70,0.5061240826985394,0.5748739284847599,0.32,0
21,51,1071,106,85,0.5311034772915505,0.43139920615987554,0.4117647058823529,0
12,79,948,125,113,0.4910157824525915,0.30847906884471893,0.1518987341772152,0
15,100,1500,102,87,0.5183454940754454,0.5177978962618075,0.15,0
21,85,1785,106,85,0.6634669497882242,0.46995388440687824,0.24705882352941178,0
0,0,0,0,0,0.0,0.0,0.0,0
0,0,0,0,0,0.0,0.0,0.0,0
0,0,0,0,0,0.0,0.0,0.0,0
33,378,12474,76,43,1.0055414461099208,0.8693692026766697,0.0873015873015873,0
23,149,3427,135,112,0.6504398789552899,0.4318225139995278,0.15436241610738255,0
27,91,2457,137,110,0.6214945830367149,0.45574243878899423,0.2967032967032967,0
15,100,1500,135,120,0.7107374630167462,0.6235061361839473,0.15,0
22,59,1298,67,45,0.6884781774605608,0.21770047897979086,0.3728813559322034,0
33,438,14454,67,34,0.7341734483132769,0.6026261863910654,0.07534246575342465,0
13,52,676,134,121,0.578210292566008,0.38794894678977426,0.25,0
18,95,1710,138,120,0.5791148059471652,0.4505909827676516,0.18947368421052632,0
12,70,840,129,117,0.5318266463266882,0.20873310635931358,0.17142857142857143,0
12,55,660,100,88,0.5030625699662156,0.0,0.21818181818181817,0
14,46,644,135,121,0.5525513069080457,0.22317785290862052,0.30434782608695654,0
12,52,624,130,118,0.49905590985747295,0.14586160003312781,0.23076923076923078,0
31,85,2635,123,92,0.49805283841446196,0.22975094114149255,0.36470588235294116,0
35,199,6965,131,96,0.502379994407263,0.2835161398371579,0.17587939698492464,0
20,101,2020,137,117,0.5109008875908748,0.22121793334254372,0.19801980198019803,0
28,92,2576,107,79,0.4936272190875161,0.3411796767803799,0.30434782608695654,0
17,64,1088,136,119,0.5054213862696134,0.03465943350267831,0.265625,0
12,66,792,124,112,0.5140221887751323,0.2202022460593741,0.18181818181818182,0
15,54,810,134,119,0.5113121729957876,0.23460425398922485,0.2777777777777778,0
29,77,2233,118,89,0.49786560463523827,0.25912169500539034,0.37662337662337664,0
27,63,1701,123,96,0.4849049084772474,0.13513519498030488,0.42857142857142855,0
12,66,792,136,124,0.5144092409838757,0.1592262982563383,0.18181818181818182,0
32,113,3616,134,102,0.6270978104767978,0.3614098552437584,0.2831858407079646,0
51,35,1785,187,136,0.9736494174241247,0.12723887689636512,1.457142857142857,0
41,330,13530,140,99,0.5982380719490054,0.3016113140645851,0.12424242424242424,0
32,64,2048,136,104,0.58637826915883,0.46368396755827024,0.5,0
21,98,2058,136,115,0.5580944020987414,0.3026770529104593,0.21428571428571427,0
14,54,756,87,73,0.5547616740896993,0.45677523209881465,0.25925925925925924,0
13,71,923,123,110,0.5456578349610341,0.4135437809420206,0.18309859154929578,0
17,115,1955,132,115,0.5720649330820611,0.4578266936357664,0.14782608695652175,0
17,112,1904,128,111,0.561465557780793,0.2520727798984873,0.15178571428571427,0
15,48,720,64,49,0.5581777910062595,0.41727887823693777,0.3125,0
0,0,0,0,0,0.0,0.0,0.0,0
34,989,33626,66,32,1.2523108909971767,1.243522800177295,0.034378159757330634,0
31,588,18228,64,33,0.7614124942674964,0.7884734947890456,0.05272108843537415,0
31,611,18941,63,32,0.670975025283199,0.6093078801264399,0.05073649754500818,0
43,1039,44677,131,88,0.7198068775427007,0.6592633026116078,0.04138594802694899,0
22,32,704,131,109,0.8221051300509381,0.730209716418175,0.6875,0
55,1069,58795,133,78,0.6240547676172666,0.5580782028906415,0.05144995322731525,0
0,0,0,0,0,0.0,0.0,0.0,0
26,89,2314,110,84,0.9294260096330071,0.675089491962393,0.29213483146067415,0
19,75,1425,105,86,0.7701100071326504,0.5446170361362824,0.25333333333333335,0
0,0,0,0,0,0.0,0.0,0.0,0
54,117,6318,187,133,1.1718166021506629,0.7132488594273625,0.46153846153846156,1
24,62,1488,187,163,0.7698534146159721,0.40956000513431245,0.3870967741935484,0
57,138,7866,187,130,1.6358741849556573,1.098486746747187,0.41304347826086957,1
29,67,1943,113,84,0.6068445599619736,0.3377699756758749,0.43283582089552236,0
29,152,4408,130,101,0.6040434850794925,0.48190837501998907,0.19078947368421054,0
145,827,119915,187,42,0.583491692539965,0.2977700584152377,0.17533252720677148,1
122,290,35380,187,65,1.6820120610919616,1.3712684037625695,0.4206896551724138,1
17,83,1411,63,46,0.8103671841597428,0.76077463287974,0.20481927710843373,0
18,71,1278,64,46,0.6596741477022048,0.5753499991342708,0.2535211267605634,0
24,121,2904,124,100,0.6694831952319384,0.5180429401899878,0.19834710743801653,0
15,93,1395,131,116,0.5870097178784343,0.49810417252628586,0.16129032258064516,0
14,58,812,137,123,0.5964325875551254,0.4797226595866276,0.2413793103448276,0
24,97,2328,136,112,0.4916992693244265,0.22168720229374658,0.24742268041237114,0
21,106,2226,187,166,0.7545301706839667,0.5357154679137734,0.19811320754716982,1
16,86,1376,133,117,0.5348674983862125,0.38446611582585455,0.18604651162790697,0
154,162,24948,187,33,1.5752012136416627,0.9220278760130205,0.9506172839506173,1
24,50,1200,187,163,0.6034463722407065,0.36111014712092476,0.48,0
19,115,2185,137,118,0.5646528392135239,0.44369061945770577,0.16521739130434782,0
32,332,10624,139,107,0.5783353683438454,0.4330880816007291,0.0963855421686747,0
62,641,39742,137,75,0.5862971564378942,0.6022175354470077,0.0967238689547582,0
19,121,2299,134,115,0.5637568632265112,0.3607837343413169,0.15702479338842976,0
123,174,21402,187,64,0.5874353637815031,0.21027401976682772,0.7068965517241379,1
26,140,3640,138,112,0.46902650889751996,0.10991443641844759,0.18571428571428572,0
145,190,27550,187,42,2.670936410150345,2.7931402494837467,0.7631578947368421,1
14,47,658,134,120,0.4991990000742398,0.22527634491858126,0.2978723404255319,0
0,0,0,0,0,0.0,0.0,0.0,0
14,43,602,127,113,0.4883349934992883,0.1903437981374709,0.32558139534883723,0
15,82,1230,119,104,0.46955145637510615,0.08663722487008278,0.18292682926829268,0
28,119,3332,131,103,0.4552875671074904,0.19591188838315735,0.23529411764705882,0
15,83,1245,130,115,0.47996963207253124,0.20729942809898103,0.18072289156626506,0
15,41,615,147,132,0.4853132541259616,0.010808661570172046,0.36585365853658536,0
32,44,1408,151,119,0.4161944706200129,0.0,0.7272727272727273,0
15,63,945,186,171,0.4058425380388137,0.11278328622149376,0.23809523809523808,0
18,41,738,118,100,0.4131047959948722,0.0,0.43902439024390244,0
41,206,8446,154,113,0.4617483560209814,0.13620158286313722,0.19902912621359223,0
49,60,2940,187,138,0.36860065900970745,0.0,0.8166666666666667,0
16,39,624,149,133,0.34326541216338113,0.11349945338563151,0.41025641025641024,0
32,75,2400,187,155,0.36145038124160533,0.0,0.4266666666666667,0
24,131,3144,129,105,0.5035718949296741,0.2520711563940605,0.183206106870229,0
35,749,26215,68,33,0.6023314145488529,0.45674438751780594,0.04672897196261682,0
17,37,629,182,165,0.43671652718840087,0.0,0.4594594594594595,0
15,47,705,187,172,0.5177369205131342,0.0,0.3191489361702128,0
11,57,627,187,176,0.6375324896542536,0.0,0.19298245614035087,0
21,132,2772,133,112,0.6465668167082685,0.6322036474171252,0.1590909090909091,0
22,55,1210,136,114,0.5064912989424099,0.3138890616074469,0.4,0
12,66,792,66,54,0.5320840101905365,0.5123412657491039,0.18181818181818182,0
14,55,770,127,113,0.5752514856477493,0.6018181078734406,0.2545454545454545,0
13,48,624,62,49,0.5701576062677587,0.4111871656315941,0.2708333333333333,0
15,75,1125,132,117,0.6281668084925218,0.5838211893699945,0.2,0
15,98,1470,135,120,0.5364244512484417,0.4477748154520055,0.15306122448979592,0
33,843,27819,139,106,0.6446345975358421,0.5440887730147891,0.03914590747330961,0
16,98,1568,136,120,0.5349437340358774,0.43019754930705784,0.16326530612244897,0
39,185,7215,136,97,0.795827518584585,0.5535468114373817,0.21081081081081082,0
39,565,22035,133,94,0.7909451755397713,0.6445023781003341,0.06902654867256637,0
12,85,1020,130,118,0.622429819123446,0.5443844578368062,0.1411764705882353,0
33,1099,36267,66,33,0.9473149734075508,0.9765256016388321,0.03002729754322111,0
48,1214,58272,133,85,0.5677632839598605,0.4069497736982948,0.039538714991762765,0
0,0,0,0,0,0.0,0.0,0.0,0
0,0,0,0,0,0.0,0.0,0.0,0
41,1355,55555,132,91,0.7636627209063548,0.6895314066963625,0.03025830258302583,0
0,0,0,0,0,0.0,0.0,0.0,0
31,1201,37231,129,98,0.8953983640909823,0.835408648971058,0.025811823480432972,0
16,58,928,102,86,0.7009850797571741,0.5218071857947651,0.27586206896551724,0
44,1062,46728,130,86,0.6895006093760889,0.6658245021467906,0.04143126177024482,0
0,0,0,0,0,0.0,0.0,0.0,0
0,0,0,0,0,0.0,0.0,0.0,0
57,130,7410,187,130,1.1349997493803599,0.9851398079918025,0.43846153846153846,1
0,0,0,0,0,0.0,0.0,0.0,0
19,86,1634,63,44,0.7113565728667999,0.6760585775613547,0.22093023255813954,0
0,0,0,0,0,0.0,0.0,0.0,0
18,111,1998,135,117,0.5590540893137566,0.4022089736677212,0.16216216216216217,0
16,49,784,182,166,0.5345305835600542,0.30662398467193364,0.32653061224489793,0
27,192,5184,136,109,0.599265692760299,0.23531509556091268,0.140625,0
26,162,4212,137,111,0.5155852296009953,0.3141448912881805,0.16049382716049382,0
19,49,931,105,86,0.5492343615026386,0.18504897424365915,0.3877551020408163,0
13,91,1183,137,124,0.5199505751737564,0.2968266207563007,0.14285714285714285,0
24,97,2328,135,111,0.5228755392189219,0.2850344530577223,0.24742268041237114,0
16,55,880,133,117,0.5911805456142941,0.32820070180329985,0.2909090909090909,0
15,70,1050,135,120,0.6287697643487883,0.40735172991206176,0.21428571428571427,0
22,57,1254,67,45,0.5088944788094513,0.29761166483495294,0.38596491228070173,0
13,79,1027,132,119,0.550208987140574,0.3644441228135947,0.16455696202531644,0
38,201,7638,84,46,0.4831119633641013,0.028761511806824798,0.1890547263681592,0
15,57,855,132,117,0.5212702656690976,0.1389944989678584,0.2631578947368421,0
13,84,1092,122,109,0.6205387688390082,0.4511864663334203,0.15476190476190477,0
12,83,996,131,119,0.521488723923863,0.2689798586837214,0.14457831325301204,0
24,169,4056,131,107,0.49245493347600816,0.08913345572722539,0.14201183431952663,0
18,38,684,103,85,0.4766520715560921,0.0,0.47368421052631576,0
12,84,1008,132,120,0.4961813319816108,0.18235887231085415,0.14285714285714285,0
11,69,759,62,51,0.5198106865730506,0.3596584895876083,0.15942028985507245,0
14,85,1190,130,116,0.5128527389386073,0.3925401020780443,0.16470588235294117,0
21,112,2352,129,108,0.5446005379494967,0.3108904431081083,0.1875,0
29,204,5916,66,37,0.5577298893658816,0.24623280602231026,0.14215686274509803,0
13,62,806,132,119,0.6567336657710073,0.6317336743227704,0.20967741935483872,0
49,244,11956,133,84,0.5269895625676981,0.33451571805949626,0.20081967213114754,0
26,92,2392,134,108,0.5663413629664695,0.46521369056193657,0.2826086956521739,0
13,87,1131,134,121,0.5642630697218799,0.5186715690314493,0.14942528735632185,0
23,67,1541,130,107,0.49995085942108436,0.41665162997941224,0.34328358208955223,0
18,61,1098,135,117,0.50534069180743,0.4266201115110818,0.29508196721311475,0
15,41,615,135,120,0.5298151720655183,0.16743727991415513,0.36585365853658536,0
14,81,1134,133,119,0.5241075983831207,0.46032339497289193,0.1728395061728395,0
14,58,812,131,117,0.49280136814292147,0.42832088787170786,0.2413793103448276,0
20,82,1640,105,85,0.4937017652261422,0.2284544306249971,0.24390243902439024,0
16,73,1168,136,120,0.5383542811565826,0.3552979117476354,0.2191780821917808,0
14,80,1120,129,115,0.5600519391389218,0.4820923706026698,0.175,0
17,107,1819,135,118,0.5221480889462673,0.4110661950563256,0.1588785046728972,0
31,366,11346,137,106,0.5478993784345526,0.3155750542307427,0.08469945355191257,0
14,96,1344,131,117,0.502046885845441,0.4117669857025425,0.14583333333333334,0
20,142,2840,131,111,0.5399039135004512,0.3967692429200563,0.14084507042253522,0
0,0,0,0,0,0.0,0.0,0.0,0
20,81,1620,64,44,0.6447415693346384,0.5437824267673735,0.24691358024691357,0
0,0,0,0,0,0.0,0.0,0.0,0
10,67,670,52,42,0.677393266334051,0.6065277816688097,0.14925373134328357,0
0,0,0,0,0,0.0,0.0,0.0,0
19,106,2014,106,87,0.9712006019114959,1.0487882859114517,0.1792452830188679,0
0,0,0,0,0,0.0,0.0,0.0,0
0,0,0,0,0,0.0,0.0,0.0,0
0,0,0,0,0,0.0,0.0,0.0,0
0,0,0,0,0,0.0,0.0,0.0,0
0,0,0,0,0,0.0,0.0,0.0,0
17,80,1360,63,46,0.947484962335453,0.8876946072887212,0.2125,0
0,0,0,0,0,0.0,0.0,0.0,0
14,77,1078,121,107,1.4490344123434402,1.135138509400547,0.18181818181818182,0
0,0,0,0,0,0.0,0.0,0.0,0
14,85,1190,62,48,0.8239064710843852,0.8707422686031913,0.16470588235294117,0
11,76,836,101,90,0.7851558249869319,0.3879519297537574,0.14473684210526316,0
0,0,0,0,0,0.0,0.0,0.0,0
14,71,994,127,113,0.5938328592396827,0.5484196602630084,0.19718309859154928,0
13,90,1170,64,51,0.6566635707257382,0.6384919754372711,0.14444444444444443,0
12,84,1008,58,46,0.6449615113052917,0.6305732484076401,0.14285714285714285,0
13,87,1131,131,118,0.6353836580723861,0.43209935328633853,0.14942528735632185,0
12,85,1020,137,125,0.5364065785977087,0.4551710137397491,0.1411764705882353,0
11,66,726,125,114,0.5797275279955411,0.5274969912587044,0.16666666666666666,0
19,102,1938,137,118,0.5107841870064828,0.3722349874743769,0.18627450980392157,0
16,57,912,65,49,0.5737757548488371,0.5062223928222365,0.2807017543859649,0
34,649,22066,138,104,0.5729438038898756,0.36989734588807727,0.05238828967642527,0
34,69,2346,135,101,0.560156318866648,0.4454645821179331,0.4927536231884058,0
14,74,1036,134,120,0.6012232515208475,0.3337080284265022,0.1891891891891892,0
23,105,2415,134,111,0.49811328434316615,0.2663716338478022,0.21904761904761905,0
17,53,901,128,111,0.4872619919217544,0.0646898272785966,0.32075471698113206,0
21,53,1113,132,111,0.5059635862860734,0.4046888486880582,0.39622641509433965,0
15,51,765,130,115,0.5155955863377435,0.3070121897706455,0.29411764705882354,0
14,49,686,133,119,0.5370819026854622,0.3191775221133414,0.2857142857142857,0
34,77,2618,127,93,0.48695331841583134,0.06999840914514402,0.44155844155844154,0
12,65,780,132,120,0.4964290061236189,0.3413522644907712,0.18461538461538463,0
60,296,17760,110,50,0.4850282121405476,0.0,0.20270270270270271,0
22,99,2178,131,109,0.4807359646351677,0.1285677352835496,0.2222222222222222,0
19,105,1995,132,113,0.4619688628760995,0.027774931582484796,0.18095238095238095,0
34,99,3366,84,50,0.4820816685239587,0.01779530147525306,0.3434343434343434,0
17,46,782,124,107,0.4595911871779185,0.1279812965396664,0.3695652173913043,0
12,56,672,132,120,0.4610622458028021,0.0,0.21428571428571427,0
17,50,850,105,88,0.477944262009066,0.0,0.34,0
15,59,885,132,117,0.5214136952177578,0.16717043847467522,0.2542372881355932,0
68,385,26180,187,119,0.63154937792727,0.3159965822204849,0.17662337662337663,1
13,68,884,132,119,0.49957826357467844,0.16035993470159343,0.19117647058823528,0
13,52,676,133,120,0.49896996845415126,0.3685380808883142,0.25,0
22,60,1320,104,82,0.5382281791005589,0.0,0.36666666666666664,0
11,66,726,137,126,0.5616621024893986,0.6240888385015253,0.16666666666666666,0
13,66,858,132,119,0.5653408070369527,0.07821797223395308,0.19696969696969696,0
69,198,13662,135,66,0.4996684777112673,0.42868118832017954,0.3484848484848485,0
11,73,803,121,110,0.5304246440088565,0.3742170687675965,0.1506849315068493,0
34,180,6120,129,95,0.476700324392495,0.26989767033137396,0.18888888888888888,0
26,141,3666,69,43,0.5042967218540143,0.2804563109577147,0.18439716312056736,0
14,49,686,119,105,0.4822340985672913,0.17843414933642687,0.2857142857142857,0
14,96,1344,128,114,0.47580341583034597,0.2415930055734335,0.14583333333333334,0
13,71,923,131,118,0.525954404632646,0.4582646135034703,0.18309859154929578,0
17,102,1734,61,44,0.494248046236465,0.23865137331022998,0.16666666666666666,0
16,72,1152,135,119,0.5114843891115166,0.2467287822683175,0.2222222222222222,0
31,214,6634,136,105,0.5100401166359502,0.23080657097669552,0.14485981308411214,0
49,201,9849,134,85,0.5242537758999632,0.40108333256485124,0.24378109452736318,0
11,68,748,120,109,0.4950408775378005,0.14697495730419846,0.16176470588235295,0
15,46,690,111,96,0.512222023659102,0.15465789957690176,0.32608695652173914,0
19,91,1729,115,96,0.48266674154462486,0.10546740892106445,0.2087912087912088,0
20,55,1100,121,101,0.514379260029422,0.26417867274995427,0.36363636363636365,0
28,73,2044,114,86,0.5906541196791214,0.31986992881477544,0.3835616438356164,0
18,78,1404,135,117,0.5087727436643903,0.37087691158500363,0.23076923076923078,0
50,114,5700,135,85,0.4668416654070569,0.0,0.43859649122807015,0
23,129,2967,153,130,0.6285004593154427,0.21072271170391152,0.17829457364341086,0
24,133,3192,187,163,0.5938252243908407,0.34920526260624,0.18045112781954886,1
47,281,13207,132,85,0.508827175391035,0.0930435638216575,0.16725978647686832,0
20,108,2160,138,118,0.5083305934035636,0.31525839141873946,0.18518518518518517,0
23,71,1633,135,112,0.5095002619687131,0.3881825342278484,0.323943661971831,0
14,45,630,132,118,0.5109139812621174,0.2577345836232666,0.3111111111111111,0
21,83,1743,66,45,0.7114089866484193,0.40926150042299764,0.25301204819277107,0
14,68,952,139,125,0.541425507361604,0.43163114825448606,0.20588235294117646,0
12,83,996,138,126,0.6232821857475048,0.28493167537570263,0.14457831325301204,0
14,53,742,136,122,0.5204187046672749,0.3931897245012009,0.2641509433962264,0
15,83,1245,132,117,0.612838371149812,0.4935995856747592,0.18072289156626506,0
17,121,2057,139,122,0.5757583933155123,0.4062643609868893,0.14049586776859505,0
23,88,2024,138,115,0.5289060815961019,0.12717290952021226,0.26136363636363635,0
19,123,2337,139,120,0.5572090088987354,0.21923445554976997,0.15447154471544716,0
14,92,1288,133,119,0.5587137362329307,0.20851441405707904,0.15217391304347827,0
15,46,690,137,122,0.5172371685511385,0.3550516531352979,0.32608695652173914,0
21,90,1890,130,109,0.6281155389122139,0.5375392695054724,0.23333333333333334,0
17,61,1037,136,119,0.5885649874732067,0.45657333967448127,0.2786885245901639,0
36,354,12744,134,98,0.5586595905017283,0.25865911744830455,0.1016949152542373,0
11,66,726,130,119,0.5252395819630489,0.4149415534260303,0.16666666666666666,0
18,54,972,133,115,0.47948848676103273,0.038250704805267516,0.3333333333333333,0
22,55,1210,133,111,0.4835353665713819,0.17574305827806982,0.4,0
11,75,825,132,121,0.5210492575648992,0.2786242093646699,0.14666666666666667,0
13,64,832,131,118,0.48344977413383344,0.21286077068899986,0.203125,0
12,62,744,131,119,0.49708894823008287,0.17935392989235918,0.1935483870967742,0
15,57,855,133,118,0.5025451701145386,0.216644550806245,0.2631578947368421,0
15,41,615,108,93,0.5006122363428283,0.0,0.36585365853658536,0
14,57,798,131,117,0.5275067532360591,0.3580029575657471,0.24561403508771928,0
14,46,644,129,115,0.49768051844620415,0.2033946694649501,0.30434782608695654,0
18,62,1116,129,111,0.47432200842114997,0.25575385253349786,0.2903225806451613,0
16,52,832,107,91,0.5207548538271023,0.35152923910131717,0.3076923076923077,0
25,121,3025,99,74,0.4864848030233296,0.0,0.2066115702479339,0
17,74,1258,108,91,0.47888138917036693,0.3333804497672176,0.22972972972972974,0
16,63,1008,103,87,0.49267690919612456,0.0,0.25396825396825395,0
10,62,620,150,140,0.5394295277918835,0.51376531574558,0.16129032258064516,0
25,106,2650,96,71,0.5032723924442281,0.09998940878541412,0.2358490566037736,0
18,102,1836,133,115,0.5914130377171839,0.3812646883239153,0.17647058823529413,0
12,52,624,104,92,0.6531054685546976,0.0,0.23076923076923078,0
44,530,23320,139,95,0.5713598467340938,0.3899413679447647,0.0830188679245283,0
21,65,1365,136,115,0.5470992754771015,0.22765639760653342,0.3230769230769231,0
21,51,1071,102,81,0.5505226990793255,0.43370884270746246,0.4117647058823529,0
35,404,14140,135,100,0.49982289197664725,0.2799534413055925,0.08663366336633663,0
13,57,741,128,115,0.5812735170294994,0.3408801635631485,0.22807017543859648,0
17,43,731,123,106,0.4859081190918124,0.11555096818573461,0.3953488372093023,0
24,121,2904,83,59,0.5393628791143278,0.33292370696250784,0.19834710743801653,0
11,70,770,131,120,0.49010753961878734,0.23894946447610174,0.15714285714285714,0
21,141,2961,135,114,0.5164003996634794,0.3075627876629585,0.14893617021276595,0
15,73,1095,69,54,0.5544394577868077,0.18686182115743852,0.2054794520547945,0
21,86,1806,123,102,0.5465750534590215,0.28418589526100635,0.2441860465116279,0
30,156,4680,132,102,0.48334703108185745,0.16548144182969626,0.19230769230769232,0
49,705,34545,136,87,0.5695105476749411,0.49045649432019267,0.06950354609929078,0
51,539,27489,135,84,0.544598978472751,0.4157126666350167,0.09461966604823747,0
12,76,912,122,110,0.5582094614324951,0.28900108527687446,0.15789473684210525,0
11,73,803,132,121,0.5425806029566098,0.39665026233453515,0.1506849315068493,0
23,154,3542,134,111,0.6226441318908991,0.4639235997036119,0.14935064935064934,0
16,40,640,132,116,0.55424542995457,0.5936685312254847,0.4,0
15,73,1095,62,47,0.6120842308480199,0.558612420632545,0.2054794520547945,0
17,121,2057,63,46,0.6168990449739574,0.4792601560522286,0.14049586776859505,0
13,55,715,129,116,0.639915772055867,0.5190892147824983,0.23636363636363636,0
21,62,1302,186,165,0.7644322115762613,0.572322619476281,0.3387096774193548,1
13,71,923,187,174,0.764883191818222,0.5274227019070553,0.18309859154929578,1
21,82,1722,66,45,0.8130448281318893,0.5987812840094123,0.25609756097560976,0
15,71,1065,65,50,0.6403393929859976,0.5973476910894967,0.2112676056338028,0
31,548,16988,137,106,0.6461104763299227,0.48586095052484796,0.05656934306569343,0
20,129,2580,65,45,0.5643279103515964,0.31404681870160045,0.15503875968992248,0
16,40,640,101,85,0.5088661833074893,0.0,0.4,0
16,64,1024,135,119,0.563668673886198,0.35827102743514566,0.25,0
20,99,1980,137,117,0.5306411266783737,0.3164951066977203,0.20202020202020202,0
15,65,975,136,121,0.5595365603991249,0.4611220789151673,0.23076923076923078,0
16,107,1712,136,120,0.514451033631657,0.30370124178545,0.14953271028037382,0
20,94,1880,135,115,0.494622058733957,0.38663163962251584,0.2127659574468085,0
24,154,3696,135,111,0.5517125958462862,0.5042449435467576,0.15584415584415584,0
14,48,672,132,118,0.553232743508912,0.22216881596629892,0.2916666666666667,0
27,101,2727,129,102,0.49205946489842617,0.14073269887120327,0.26732673267326734,0
18,49,882,105,87,0.5557855215367908,0.09649332429728685,0.3673469387755102,0
67,320,21440,137,70,0.5606483642013623,0.4475823926639757,0.209375,0
60,304,18240,136,76,0.6089414249169752,0.524383819541347,0.19736842105263158,0
21,92,1932,129,108,0.7184750260932141,0.2827860223627696,0.22826086956521738,0
23,94,2162,136,113,0.48761367660375304,0.3253552962930242,0.24468085106382978,0
12,61,732,122,110,0.5622999936897621,0.39688241623026765,0.19672131147540983,0
11,69,759,135,124,0.46389609527359593,0.3232458621102851,0.15942028985507245,0
21,105,2205,132,111,0.47103579795421824,0.23545763139355927,0.2,0
11,67,737,131,120,0.48252500293939476,0.15789768796543424,0.16417910447761194,0
23,101,2323,135,112,0.46036165846162547,0.19743601194290283,0.22772277227722773,0
15,43,645,151,136,0.4812570207566434,0.0,0.3488372093023256,0
16,88,1408,137,121,0.477572886781521,0.30073726555664615,0.18181818181818182,0
12,74,888,133,121,0.5002068807075171,0.2700744053641443,0.16216216216216217,0
30,118,3540,137,107,0.4871252990805173,0.23644819696877792,0.2542372881355932,0
23,58,1334,110,87,0.4568595702998468,0.0,0.39655172413793105,0
20,63,1260,129,109,0.5152175424444009,0.14926135830944554,0.31746031746031744,0
16,49,784,108,92,0.4798473132510995,0.0,0.32653061224489793,0
12,71,852,132,120,0.5294386494670181,0.2696539313895407,0.16901408450704225,0
14,90,1260,131,117,0.497883549920346,0.27386162823113896,0.15555555555555556,0
15,97,1455,117,102,0.5023858724253534,0.0958436658322119,0.15463917525773196,0
22,144,3168,65,43,0.5157589872666515,0.37925044639907207,0.1527777777777778,0
34,808,27472,137,103,0.6135058268965176,0.36649651234024244,0.04207920792079208,0
13,89,1157,132,119,0.5799657140669501,0.32178172558870455,0.14606741573033707,0
17,49,833,133,116,0.5037175246588635,0.4093601258707445,0.3469387755102041,0
19,119,2261,135,116,0.5027200370310487,0.33367082057060765,0.15966386554621848,0
28,66,1848,104,76,0.5331163327086367,0.16614855001592746,0.42424242424242425,0
0,0,0,0,0,0.0,0.0,0.0,0
47,421,19787,138,91,0.49713308266231554,0.06502096244149959,0.11163895486935867,0
16,87,1392,132,116,0.5145272337483927,0.42761798705988724,0.1839080459770115,0
14,53,742,105,91,0.5428302825717555,0.0,0.2641509433962264,0
29,104,3016,115,86,0.526915785880682,0.0,0.27884615384615385,0
16,56,896,117,101,0.503090134108724,0.11579448759487931,0.2857142857142857,0
19,111,2109,130,111,0.5261999830097778,0.3517659673142785,0.17117117117117117,0
19,79,1501,124,105,0.4701285334219986,0.11402166772757608,0.24050632911392406,0
51,54,2754,137,86,0.6759506716598089,0.5089745809856165,0.9444444444444444,0
14,84,1176,60,46,0.6318984409597376,0.6005955086102347,0.16666666666666666,0
0,0,0,0,0,0.0,0.0,0.0,0
22,123,2706,66,44,1.2180014569012352,0.9505369553931098,0.17886178861788618,0
0,0,0,0,0,0.0,0.0,0.0,0
0,0,0,0,0,0.0,0.0,0.0,0
18,116,2088,63,45,0.6274181619392966,0.500436411121019,0.15517241379310345,0
0,0,0,0,0,0.0,0.0,0.0,0
11,71,781,64,53,0.6736623455831814,0.5064053099497313,0.15492957746478872,0
24,125,3000,187,163,0.7461316494872346,0.6365185969761565,0.192,1
0,0,0,0,0,0.0,0.0,0.0,0
0,0,0,0,0,0.0,0.0,0.0,0
0,0,0,0,0,0.0,0.0,0.0,0
0,0,0,0,0,0.0,0.0,0.0,0
0,0,0,0,0,0.0,0.0,0.0,0
21,124,2604,65,44,0.562164325887514,0.38370290901756043,0.1693548387096774,0
12,69,828,135,123,0.638115339739523,0.49839223675109556,0.17391304347826086,0
12,72,864,134,122,0.6031696409405085,0.5602540074454496,0.16666666666666666,0
26,144,3744,137,111,0.579417379551394,0.37484810057455137,0.18055555555555555,0
0,0,0,0,0,0.0,0.0,0.0,0
23,75,1725,111,88,0.5400440324547204,0.0,0.30666666666666664,0
16,62,992,135,119,0.5343998705504942,0.2430263697917551,0.25806451612903225,0
13,79,1027,123,110,0.5293680300611054,0.2641532413222296,0.16455696202531644,0
18,71,1278,109,91,0.49799125550623535,0.0,0.2535211267605634,0
10,67,670,133,123,0.5998405064114298,0.3699712808128709,0.14925373134328357,0
45,496,22320,133,88,0.5537087924501898,0.48295976659974615,0.0907258064516129,0
13,63,819,123,110,0.5472631187738709,0.2609293406042517,0.20634920634920634,0
14,63,882,132,118,0.5440240901307212,0.32905716015872644,0.2222222222222222,0
21,88,1848,67,46,0.4799349860828001,0.14061621780617267,0.23863636363636365,0
15,54,810,96,81,0.43252952814870543,0.0,0.2777777777777778,0
16,102,1632,130,114,0.5061734695768978,0.08659789163718178,0.1568627450980392,0
16,81,1296,71,55,0.4448249805613679,0.03163937487158707,0.19753086419753085,0
15,50,750,127,112,0.44287285391514647,0.14973738864469185,0.3,0
17,58,986,128,111,0.47712299067455255,0.2957354459930707,0.29310344827586204,0
17,51,867,129,112,0.4599695374019016,0.19070212283151072,0.3333333333333333,0
15,49,735,129,114,0.47877615042820976,0.16642719033212278,0.30612244897959184,0
12,61,732,124,112,0.4622966871143992,0.17344763207843,0.19672131147540983,0
15,57,855,125,110,0.47380641239709836,0.15655038466822188,0.2631578947368421,0
17,71,1207,131,114,0.4967598630943756,0.13068137665021334,0.23943661971830985,0
11,68,748,129,118,0.5090021855794665,0.31018564932380804,0.16176470588235295,0
16,63,1008,129,113,0.47059976235287887,0.25324028920044866,0.25396825396825395,0
13,48,624,127,114,0.49615462629589774,0.1382607302519837,0.2708333333333333,0
20,93,1860,129,109,0.5915745845185236,0.5013559145666455,0.21505376344086022,0
19,103,1957,131,112,0.5458969135294355,0.34180665448077613,0.18446601941747573,0
21,90,1890,132,111,0.49079570558512553,0.29631080148654015,0.23333333333333334,0
19,84,1596,104,85,0.5207695087635558,0.0,0.2261904761904762,0
44,266,11704,131,87,0.515349132832404,0.2443250776738801,0.16541353383458646,0
24,72,1728,174,150,2.038491557405916,0.8336813858129936,0.3333333333333333,0
21,77,1617,173,152,0.8325025041294049,0.6095143895483119,0.2727272727272727,0
22,77,1694,174,152,0.8173996684390056,0.47439158407230625,0.2857142857142857,0
17,73,1241,69,52,0.5073224318430364,0.43756298390784265,0.2328767123287671,0
13,63,819,133,120,0.5982510431001765,0.31637945534291523,0.20634920634920634,0
13,56,728,132,119,0.6009033182775944,0.3873271915343244,0.23214285714285715,0
26,129,3354,69,43,0.5787315663067393,0.46183271662852154,0.20155038759689922,0
13,56,728,101,88,0.7064449514428636,0.0,0.23214285714285715,0
13,60,780,117,104,0.5729379778098098,0.3406690280810407,0.21666666666666667,0
31,203,6293,134,103,0.6800456596834645,0.2776033014818617,0.15270935960591134,0
14,67,938,100,86,0.6225764196434866,0.0,0.208955223880597,0
19,105,1995,129,110,0.9323106368025862,0.9959525038068927,0.18095238095238095,0
44,517,22748,129,85,1.6525247210689833,1.737242649013132,0.0851063829787234,0
14,81,1134,101,87,0.861556464503287,0.8211485777936622,0.1728395061728395,0
30,144,4320,128,98,0.970348809653411,1.0363731603504083,0.20833333333333334,0
18,122,2196,117,99,0.6727127936931666,0.5264154209557559,0.14754098360655737,0
43,669,28767,127,84,0.6606553250614118,0.5412078952549383,0.06427503736920777,0
0,0,0,0,0,0.0,0.0,0.0,0
15,51,765,116,101,0.6810503996046979,0.2629490611933311,0.29411764705882354,0
18,127,2286,101,83,0.562255681030189,0.6192893116543506,0.14173228346456693,0
12,64,768,128,116,0.643221905894229,0.5163996423026956,0.1875,0
46,79,3634,187,141,0.4330378332515087,0.04410780217563569,0.5822784810126582,0
18,105,1890,131,113,0.49907811690457443,0.359424575236582,0.17142857142857143,0
16,44,704,115,99,0.558836659449622,0.40663443433442376,0.36363636363636365,0
17,111,1887,132,115,0.5738241217943747,0.29724265138192973,0.15315315315315314,0
21,137,2877,101,80,0.5767495060586239,0.6638645348713765,0.15328467153284672,0
18,79,1422,129,111,0.55430698532049,0.3437268062778185,0.22784810126582278,0
23,87,2001,102,79,0.5905931464992364,0.6840390439283001,0.26436781609195403,0
17,93,1581,124,107,0.586764751090485,0.26635591452610213,0.1827956989247312,0
17,90,1530,131,114,0.5951458640920487,0.40795817302108545,0.18888888888888888,0
18,73,1314,64,46,0.49168267150500367,0.24835372368695968,0.2465753424657534,0
24,88,2112,105,81,0.5793538825479474,0.5918408330011401,0.2727272727272727,0
13,92,1196,123,110,0.553833261247626,0.30641694972861605,0.14130434782608695,0
15,57,855,135,120,0.6741350863659035,0.563343143851719,0.2631578947368421,0
28,183,5124,132,104,0.5399501118668867,0.1920137863900601,0.15300546448087432,0
10,64,640,130,120,0.5868351035347485,0.6056218489850963,0.15625,0
12,59,708,134,122,0.5646016137761861,0.5225754284780549,0.2033898305084746,0
32,210,6720,133,101,0.609287979013909,0.48944191663250264,0.1523809523809524,0
23,157,3611,109,86,0.5666204231170106,0.586960799556987,0.1464968152866242,0
24,134,3216,111,87,0.6008836682713314,0.44162410966565496,0.1791044776119403,0
14,94,1316,132,118,0.5411589516999711,0.31720014155988135,0.14893617021276595,0
20,101,2020,132,112,0.49767373163348505,0.0704683102218895,0.19801980198019803,0
19,89,1691,134,115,0.47571260937315024,0.23532573205264634,0.21348314606741572,0
11,67,737,132,121,0.5145281239147022,0.41040108082961296,0.16417910447761194,0
24,63,1512,187,163,0.5281484665328596,0.265075691846295,0.38095238095238093,0
20,107,2140,129,109,0.5107700854037387,0.15706884686842604,0.18691588785046728,0
14,81,1134,132,118,0.4992628788760999,0.2564896432376642,0.1728395061728395,0
11,75,825,133,122,0.527122230157137,0.4169707972514266,0.14666666666666667,0
15,90,1350,130,115,0.5117197513516494,0.21824404127612887,0.16666666666666666,0
10,69,690,133,123,0.5031637652897973,0.4138981006835013,0.14492753623188406,0
20,70,1400,108,88,0.48524036721512004,0.0,0.2857142857142857,0
23,49,1127,124,101,0.5016313596674168,0.12111922261064335,0.46938775510204084,0
53,343,18179,135,82,0.4660024228033018,0.0625238498595081,0.15451895043731778,0
26,139,3614,134,108,0.47791321051927144,0.21206851149343822,0.18705035971223022,0
23,101,2323,134,111,0.5284507808314891,0.2602643509625331,0.22772277227722773,0
16,94,1504,135,119,0.5788827493578834,0.38871153352474014,0.1702127659574468,0
19,93,1767,132,113,0.635151083506303,0.6499497453461924,0.20430107526881722,0
50,257,12850,137,87,0.5750032032505079,0.40982599254630564,0.19455252918287938,0
56,305,17080,137,81,0.5488252507620491,0.4435759550010155,0.18360655737704917,0
14,91,1274,136,122,0.650728078561628,0.4664576252965902,0.15384615384615385,0
16,81,1296,134,118,0.545421984417655,0.2957725405331233,0.19753086419753085,0
15,78,1170,136,121,0.602488314034432,0.32688508326375576,0.19230769230769232,0
17,120,2040,105,88,0.5650337447055082,0.0,0.14166666666666666,0
12,76,912,131,119,0.5495672109196874,0.16749489632841902,0.15789473684210525,0
10,71,710,126,116,0.5639258467221088,0.2758517803191786,0.14084507042253522,0
15,74,1110,126,111,0.5137342931544462,0.41111526410683197,0.20270270270270271,0
22,74,1628,106,84,0.5543062243718521,0.27973957343710165,0.2972972972972973,0
13,56,728,125,112,0.5816278931538303,0.5369239028979289,0.23214285714285715,0
15,51,765,103,88,0.5976353759558397,0.529771186143794,0.29411764705882354,0
75,416,31200,106,31,0.8430922158319525,0.7589028218788226,0.18028846153846154,0
73,638,46574,105,32,1.0560747072461025,1.0004267000648677,0.11442006269592477,0
64,972,62208,129,65,0.8749246990208881,0.8217709228348822,0.06584362139917696,0
20,95,1900,84,64,1.1675916812131852,1.1058177558873366,0.21052631578947367,0
18,101,1818,85,67,1.3867111580814508,1.4309942682375498,0.1782178217821782,0
57,208,11856,90,33,0.6492177443916113,0.5131978085406576,0.27403846153846156,0
39,151,5889,77,38,0.7518497699533779,0.7113033365385956,0.2582781456953642,0
44,527,23188,130,86,1.1305672264165443,1.1333354090385972,0.08349146110056926,0
41,788,32308,129,88,1.2259927100794852,1.292453312175529,0.05203045685279188,0
17,68,1156,63,46,0.9990265047412941,1.0051354034276865,0.25,0
0,0,0,0,0,0.0,0.0,0.0,0
0,0,0,0,0,0.0,0.0,0.0,0
37,497,18389,126,89,0.8106933803846473,0.6316671139507352,0.0744466800804829,0
18,67,1206,64,46,0.6943859702157829,0.6285134812557207,0.26865671641791045,0
21,91,1911,64,43,0.7460037150932702,0.40037807852169116,0.23076923076923078,0
11,56,616,138,127,0.6504332231369531,0.6344400698515134,0.19642857142857142,0
19,72,1368,137,118,0.6052589525990164,0.5969288255600649,0.2638888888888889,0
16,62,992,114,98,0.7883471138027403,0.44864491257577443,0.25806451612903225,0
12,83,996,132,120,0.7282173236578543,0.4586531269598607,0.14457831325301204,0
15,65,975,133,118,0.6754013875574731,0.5604907522926281,0.23076923076923078,0
15,78,1170,133,118,0.5575331881944392,0.33147217057987655,0.19230769230769232,0
24,85,2040,134,110,0.5329973615524866,0.31225301611994405,0.2823529411764706,0
18,96,1728,136,118,0.5009330172448448,0.3479180544680779,0.1875,0
15,95,1425,134,119,0.583608175645347,0.36165149529502666,0.15789473684210525,0
18,97,1746,137,119,0.6212815222912903,0.5270150600637377,0.18556701030927836,0
13,73,949,132,119,0.560236510658153,0.30373679786134045,0.1780821917808219,0
11,60,660,100,89,0.5783385686722096,0.3901551595648285,0.18333333333333332,0
15,78,1170,135,120,0.5519697531309979,0.44872842072786046,0.19230769230769232,0
11,56,616,82,71,0.5868921766139426,0.5544025304156333,0.19642857142857142,0
29,122,3538,62,33,0.5916479299985075,0.25113048898773743,0.23770491803278687,0
25,58,1450,136,111,0.5264139991738743,0.40757567615219253,0.43103448275862066,0
18,61,1098,106,88,0.5706180288437694,0.504853666961016,0.29508196721311475,0
28,57,1596,63,35,0.5472571147747356,0.342820374558911,0.49122807017543857,0
18,41,738,115,97,0.5446123073353211,0.42211588240887443,0.43902439024390244,0
15,66,990,96,81,0.6601486798037216,0.428487013460663,0.22727272727272727,0
13,51,663,97,84,0.610490625225442,0.40657368055146836,0.2549019607843137,0
14,74,1036,133,119,0.5731829478317314,0.3020040584240141,0.1891891891891892,0
41,153,6273,113,72,0.7092912161275512,0.3277633023500142,0.2679738562091503,0
35,204,7140,65,30,0.6971897127494726,0.4291189968173005,0.1715686274509804,0
15,60,900,133,118,0.5131271519915606,0.21303414026461154,0.25,0
12,56,672,130,118,0.5766863206644541,0.35576003499324926,0.21428571428571427,0
22,62,1364,106,84,0.578324883542236,0.0,0.3548387096774194,0
17,63,1071,135,118,0.503330226668222,0.25594856914117914,0.2698412698412698,0
16,107,1712,127,111,0.5112895577726642,0.1425485908985686,0.14953271028037382,0
36,191,6876,135,99,0.9463061166224151,0.5225024147684317,0.18848167539267016,0
18,39,702,184,166,0.5005271901780485,0.026897190050824832,0.46153846153846156,0
38,41,1558,149,111,0.5015307313253115,0.0,0.926829268292683,0
23,47,1081,187,164,0.48409535944859505,0.018755046062310328,0.48936170212765956,0
74,50,3700,186,112,0.444828811234013,0.0,1.48,0
24,40,960,154,130,0.5022972726955761,0.0014801188463794065,0.6,0
18,41,738,153,135,0.6079755295254843,0.014276077211583997,0.43902439024390244,0
18,41,738,121,103,0.6706559024276428,0.37377075739641336,0.43902439024390244,0
0,0,0,0,0,0.0,0.0,0.0,0
12,79,948,128,116,0.6468667864958842,0.42712302012285724,0.1518987341772152,0
26,155,4030,66,40,0.7175550932367871,0.5680714860898521,0.16774193548387098,0
32,113,3616,131,99,0.7540308771503262,0.46347135357732816,0.2831858407079646,0
18,63,1134,99,81,0.6940467174549516,0.5406170510142669,0.2857142857142857,0
15,60,900,96,81,0.92955204719605,0.40519798943871776,0.25,0
32,662,21184,132,100,0.8778074025817579,0.8325875837049581,0.04833836858006042,0
17,117,1989,64,47,0.742270495752749,0.6814362726823112,0.1452991452991453,0
0,0,0,0,0,0.0,0.0,0.0,0
14,69,966,100,86,0.7312043938507384,0.3539382922479435,0.2028985507246377,0
10,68,680,105,95,0.7191373591421968,0.45287486070277605,0.14705882352941177,0
0,0,0,0,0,0.0,0.0,0.0,0
0,0,0,0,0,0.0,0.0,0.0,0
34,960,32640,131,97,0.7910753836330295,0.7490152890445161,0.035416666666666666,0
42,852,35784,132,90,0.6767166977727752,0.4849385225784533,0.04929577464788732,0
34,621,21114,136,102,0.5685040851530981,0.4739997487776008,0.05475040257648953,0
42,945,39690,139,97,0.6526918851700076,0.46811224725601575,0.044444444444444446,0
21,125,2625,66,45,0.7007812660522228,0.512885677446937,0.168,0
17,96,1632,124,107,0.6345678529729315,0.4775175218758913,0.17708333333333334,0
16,38,608,64,48,0.6388727305240082,0.308111191180887,0.42105263157894735,0
17,75,1275,105,88,0.6132676142460562,0.40735046769113914,0.22666666666666666,0
13,66,858,136,123,0.6353975291067949,0.6030924279093742,0.19696969696969696,0
13,63,819,127,114,0.5770524432274576,0.28481816372140134,0.20634920634920634,0
12,70,840,125,113,0.5739686904567657,0.46620690602771353,0.17142857142857143,0
20,85,1700,135,115,0.538177512863129,0.4064176000093798,0.23529411764705882,0
22,88,1936,129,107,0.8976116280306516,0.7194356012894562,0.25,0
17,83,1411,131,114,0.5327208143815358,0.2590669665514533,0.20481927710843373,0
19,41,779,105,86,0.5599858240209256,0.3005908489435523,0.4634146341463415,0
14,67,938,103,89,0.5225550716444973,0.5619764391223084,0.208955223880597,0
20,78,1560,105,85,0.6133973637097786,0.6878620266288067,0.2564102564102564,0
10,69,690,99,89,0.5821919994015896,0.39989778652606783,0.14492753623188406,0
22,92,2024,113,91,0.5464522451141737,0.5564247846072838,0.2391304347826087,0
23,154,3542,104,81,0.6001754220375866,0.5844440598685282,0.14935064935064934,0
0,0,0,0,0,0.0,0.0,0.0,0
14,55,770,66,52,0.679168819271166,0.48566679510981864,0.2545454545454545,0
148,289,42772,187,39,0.9670049661897009,0.5381278286315055,0.5121107266435986,1
24,109,2616,137,113,0.5935402461987895,0.3640435370972086,0.22018348623853212,0
28,123,3444,137,109,0.4829945644392002,0.24070834863808083,0.22764227642276422,0
12,51,612,65,53,0.5362263234272557,0.2957910582824341,0.23529411764705882,0
43,246,10578,125,82,0.5428998141639994,0.508024344069876,0.17479674796747968,0
16,71,1136,97,81,0.5902931300360317,0.6317136260313553,0.22535211267605634,0
17,88,1496,107,90,0.6296621182133854,0.6106828922153453,0.19318181818181818,0
18,85,1530,99,81,0.5660311570089784,0.6170484874879989,0.21176470588235294,0
13,53,689,136,123,0.5645836509916539,0.37436451206533694,0.24528301886792453,0
45,214,9630,132,87,0.5239165698305125,0.32721835794567594,0.2102803738317757,0
33,324,10692,119,86,0.6273033514654434,0.5299203333313299,0.10185185185185185,0
28,158,4424,130,102,0.5590444500362467,0.2666243486997796,0.17721518987341772,0
17,64,1088,104,87,0.5897577614345252,0.40401071868741334,0.265625,0
21,104,2184,101,80,0.6725222404532465,0.5372706895173376,0.20192307692307693,0
11,56,616,122,111,0.6157510085477249,0.542188231157768,0.19642857142857142,0
17,117,1989,104,87,0.6105803897529192,0.6627138235708844,0.1452991452991453,0
17,68,1156,135,118,0.5759869960920588,0.3981623264249268,0.25,0
11,68,748,127,116,0.7351407717332384,0.463934240001466,0.16176470588235295,0
42,177,7434,124,82,0.6278424597291603,0.5348045569842851,0.23728813559322035,0
15,53,795,134,119,0.5689202348498964,0.35404778389790403,0.2830188679245283,0
19,86,1634,65,46,0.5987319931431797,0.2976204400589383,0.22093023255813954,0
26,89,2314,117,91,0.5750078110861788,0.5305743606952752,0.29213483146067415,0
14,57,798,98,84,0.5791719715081864,0.4776396647873395,0.24561403508771928,0
17,119,2023,63,46,0.5900013834340573,0.4193569011368042,0.14285714285714285,0
15,79,1185,131,116,0.5750482271840136,0.3699374240304305,0.189873417721519,0
12,53,636,128,116,0.5304809509839115,0.4087539482780744,0.22641509433962265,0
15,46,690,131,116,0.5937204410190596,0.4652219781378961,0.32608695652173914,0
24,79,1896,66,42,0.5965829210606307,0.39540054593189256,0.3037974683544304,0
25,162,4050,133,108,0.5386944043119055,0.4838719093385837,0.15432098765432098,0
0,0,0,0,0,0.0,0.0,0.0,0
0,0,0,0,0,0.0,0.0,0.0,0
0,0,0,0,0,0.0,0.0,0.0,0
0,0,0,0,0,0.0,0.0,0.0,0
11,66,726,123,112,0.7737462717946904,0.7507302317607091,0.16666666666666666,0
12,60,720,118,106,0.6620770938630032,0.49997464429675814,0.2,0
17,78,1326,66,49,0.8266042211973698,0.6703822995961332,0.21794871794871795,0
0,0,0,0,0,0.0,0.0,0.0,0
0,0,0,0,0,0.0,0.0,0.0,0
14,96,1344,131,117,0.7523659893223951,0.6026132048588669,0.14583333333333334,0
0,0,0,0,0,0.0,0.0,0.0,0
17,59,1003,132,115,0.641937772544977,0.5956040721705205,0.288135593220339,0
15,60,900,125,110,0.6935912990891951,0.6079987542115107,0.25,0
16,75,1200,133,117,0.6893992039836103,0.49570079829382824,0.21333333333333335,0
17,102,1734,135,118,0.7738155752742032,0.7358781052644007,0.16666666666666666,0
19,65,1235,118,99,0.5671744259232198,0.4353230650379689,0.2923076923076923,0
16,90,1440,133,117,0.6678976361446356,0.5737473175861593,0.17777777777777778,0
24,103,2472,131,107,0.5313167407414144,0.3827310065863575,0.23300970873786409,0
14,81,1134,135,121,0.5725245103378225,0.45665278189432684,0.1728395061728395,0
14,48,672,132,118,0.5628218123861289,0.572449806467746,0.2916666666666667,0
21,99,2079,133,112,0.6235773923130823,0.46974534397542145,0.21212121212121213,0
18,103,1854,134,116,0.5851013141917063,0.3411134446441729,0.17475728155339806,0
26,79,2054,106,80,0.5257927522726681,0.0,0.3291139240506329,0
14,62,868,129,115,0.589296947380978,0.46255738145577774,0.22580645161290322,0
17,86,1462,132,115,0.5877541396088022,0.477003756322626,0.19767441860465115,0
14,71,994,131,117,0.5391430297942233,0.4136402738378047,0.19718309859154928,0
19,95,1805,136,117,0.5571427677367135,0.3625664377747144,0.2,0
17,109,1853,134,117,0.5303844170750974,0.34762696287575817,0.1559633027522936,0
25,177,4425,135,110,0.5851319740025029,0.3814013633211329,0.14124293785310735,0
12,58,696,135,123,0.6351512817112326,0.6566566050720617,0.20689655172413793,0
39,255,9945,91,52,0.5913222122927559,0.4290936268007067,0.15294117647058825,0
48,382,18336,134,86,0.5709300942388094,0.17878058729616636,0.1256544502617801,0
22,125,2750,136,114,0.5123370579795854,0.3569188408734526,0.176,0
20,109,2180,141,121,0.4779465133421928,0.10677309067963699,0.1834862385321101,0
15,83,1245,134,119,0.5024905968612808,0.3678508671542608,0.18072289156626506,0
24,34,816,187,163,0.3766610834269336,0.0,0.7058823529411765,0
60,39,2340,187,127,0.2756917192938803,0.0,1.5384615384615385,0
55,76,4180,187,132,0.32569419525795357,0.0,0.7236842105263158,0
102,49,4998,187,85,0.2518183690807237,0.0,2.0816326530612246,0
10,64,640,128,118,0.5830953932975977,0.5658303067942231,0.15625,0
18,90,1620,64,46,0.628260520242782,0.5389441289815884,0.2,0
41,166,6806,125,84,0.6109158424645431,0.5256784907094755,0.2469879518072289,0
12,76,912,127,115,0.6804116251134987,0.572733135510714,0.15789473684210525,0
21,86,1806,104,83,0.8970308372811284,0.6367395022130394,0.2441860465116279,0
52,1102,57304,133,81,0.6713528358592017,0.5695676569469255,0.047186932849364795,0
19,34,646,130,111,0.6295724935304701,0.6474787383508198,0.5588235294117647,0
0,0,0,0,0,0.0,0.0,0.0,0
50,422,21100,131,81,0.5651540347700178,0.5244554112979581,0.11848341232227488,0
19,37,703,105,86,0.6469873389253045,0.3687731545562846,0.5135135135135135,0
32,885,28320,136,104,0.677990191198634,0.6948894842316603,0.03615819209039548,0
17,61,1037,102,85,0.7871330655327182,0.7670210159800088,0.2786885245901639,0
16,85,1360,133,117,0.7062560915820341,0.6338610399834781,0.18823529411764706,0
0,0,0,0,0,0.0,0.0,0.0,0
0,0,0,0,0,0.0,0.0,0.0,0
22,63,1386,102,80,0.6694231358723399,0.6380581265677404,0.3492063492063492,0
32,193,6176,132,100,0.5220723720895551,0.4240489419702501,0.16580310880829016,0
14,60,840,54,40,0.6808132872608224,0.5557169991547042,0.23333333333333334,0
21,82,1722,135,114,0.567393609561181,0.4745633208915138,0.25609756097560976,0
29,97,2813,67,38,0.7407397320023077,0.6783767280694349,0.29896907216494845,0
26,100,2600,132,106,0.5533079462775295,0.5369544234422051,0.26,0
11,59,649,116,105,0.5764685679063558,0.3380018485399518,0.1864406779661017,0
0,0,0,0,0,0.0,0.0,0.0,0
0,0,0,0,0,0.0,0.0,0.0,0
52,915,47580,132,80,0.6274636928321199,0.4059523069370191,0.05683060109289618,0
13,89,1157,125,112,0.6195262302853818,0.5994914883588907,0.14606741573033707,0
0,0,0,0,0,0.0,0.0,0.0,0
37,767,28379,125,88,0.5974969681417367,0.16934678075337933,0.048239895697522815,0
18,115,2070,64,46,0.656658390695115,0.6445038469577785,0.1565217391304348,0
44,979,43076,134,90,0.7543085445382087,0.6197107140714773,0.0449438202247191,0
22,99,2178,107,85,0.9727569372293415,0.7244844788438701,0.2222222222222222,0
53,932,49396,137,84,0.7228506006144806,0.5385183651767433,0.05686695278969957,0
17,67,1139,104,87,0.7404245829866554,0.44467478174656716,0.2537313432835821,0
18,109,1962,63,45,0.7114501673124959,0.5910005053979411,0.1651376146788991,0
0,0,0,0,0,0.0,0.0,0.0,0
16,98,1568,126,110,0.6099035523682635,0.4863550118462708,0.16326530612244897,0
15,89,1335,134,119,0.5847086250061867,0.33379143642736453,0.16853932584269662,0
32,139,4448,127,95,0.6991759008028918,0.5891041383737304,0.2302158273381295,1
14,74,1036,131,117,0.5996189790971964,0.43640420766025567,0.1891891891891892,0
12,77,924,130,118,0.5899122438007407,0.3535620390549567,0.15584415584415584,0
12,56,672,131,119,0.5617203940912185,0.5382865662451797,0.21428571428571427,0
57,276,15732,137,80,0.5104863541998496,0.20579638022378854,0.20652173913043478,0
18,91,1638,135,117,0.6442052500101281,0.5990660662886288,0.1978021978021978,0
18,114,2052,136,118,0.5350216709396829,0.25506351144981587,0.15789473684210525,0
12,73,876,126,114,0.5910216815039552,0.6759817722455125,0.1643835616438356,0
17,76,1292,104,87,0.640561614056254,0.04516285316470017,0.2236842105263158,0
12,64,768,132,120,0.5740111086294469,0.49770113724840115,0.1875,0
24,84,2016,109,85,0.6251195678968562,0.0,0.2857142857142857,0
13,72,936,130,117,0.5978548010714668,0.4619716085386587,0.18055555555555555,0
28,188,5264,134,106,0.6173855247028754,0.4227365773011944,0.14893617021276595,0
31,104,3224,89,58,0.5590581626306568,0.6248253320139507,0.2980769230769231,0
73,201,14673,118,45,0.4787064508688422,0.22328135068345487,0.36318407960199006,0
20,92,1840,105,85,0.7224988811781201,0.6544013777999946,0.21739130434782608,0
47,92,4324,110,63,0.4959979479113398,0.25708487752801806,0.5108695652173914,0
32,225,7200,104,72,0.5353849411717775,0.37716045685646665,0.14222222222222222,0
14,100,1400,131,117,0.5305854964360931,0.18835019208259796,0.14,0
16,77,1232,130,114,0.5043311526116335,0.23844239476070272,0.2077922077922078,0
17,69,1173,136,119,0.5264136643751722,0.3262316271372029,0.2463768115942029,0
16,105,1680,131,115,0.5602096054280533,0.42569284430930665,0.1523809523809524,0
14,69,966,133,119,0.48519153033834067,0.316956415028985,0.2028985507246377,0
16,108,1728,135,119,0.5118012731421498,0.262071798097868,0.14814814814814814,0
15,54,810,135,120,0.4984807663121871,0.3366213905091065,0.2777777777777778,0
17,115,1955,135,118,0.5595860222618433,0.351898884803168,0.14782608695652175,0
17,99,1683,134,117,0.5615318834421761,0.3271106326026695,0.1717171717171717,0
15,76,1140,133,118,0.6084931333676471,0.4344687522738125,0.19736842105263158,0
35,703,24605,138,103,0.6645065208795233,0.6044939757424789,0.049786628733997154,0
16,43,688,121,105,0.5519670669126366,0.3246126039417235,0.37209302325581395,0
65,311,20215,96,31,0.6524298997485298,0.3249829817288432,0.2090032154340836,0
11,68,748,134,123,0.6519359052276362,0.6868709213929771,0.16176470588235295,0
26,85,2210,111,85,0.5860911244826533,0.45668479950567664,0.3058823529411765,0
17,37,629,61,44,0.6391816327319614,0.6135109338125695,0.4594594594594595,0
71,146,10366,100,29,0.8857335101635674,0.4556806186992834,0.4863013698630137,0
16,50,800,114,98,0.5718088403973307,0.5331824273086125,0.32,0
16,72,1152,136,120,0.5023755947740007,0.3662188946187425,0.2222222222222222,0
19,116,2204,121,102,0.5425133129654373,0.2394082585059031,0.16379310344827586,0
10,61,610,134,124,0.5313553631039672,0.5386602587014784,0.16393442622950818,0
0,0,0,0,0,0.0,0.0,0.0,0
16,47,752,129,113,0.560870932774965,0.4511692422019608,0.3404255319148936,0
0,0,0,0,0,0.0,0.0,0.0,0
17,74,1258,57,40,0.5660511059409054,0.4213585108088584,0.22972972972972974,0
0,0,0,0,0,0.0,0.0,0.0,0
0,0,0,0,0,0.0,0.0,0.0,0
0,0,0,0,0,0.0,0.0,0.0,0
43,306,13158,128,85,0.5772048653537298,0.49724465512916394,0.14052287581699346,0
0,0,0,0,0,0.0,0.0,0.0,0
18,109,1962,137,119,0.6889700475216579,0.65579380316511,0.1651376146788991,0
28,91,2548,67,39,0.7596919223719505,0.7447033325157213,0.3076923076923077,0
18,127,2286,56,38,0.7697749832542676,0.7176133024558322,0.14173228346456693,0
20,78,1560,105,85,0.9548846221325196,0.5758961132039637,0.2564102564102564,0
16,83,1328,113,97,0.7743395169591692,0.18163752160871804,0.1927710843373494,0
22,78,1716,106,84,1.0326755515367925,0.5224245709268079,0.28205128205128205,0
15,54,810,148,133,0.7513377329346859,0.08798616662057071,0.2777777777777778,0
18,79,1422,136,118,0.6582208087210616,0.5690127781181078,0.22784810126582278,0
20,74,1480,103,83,0.5097137700080296,0.33820822904181397,0.2702702702702703,0
20,84,1680,127,107,0.7995211680326916,0.2561080496740404,0.23809523809523808,0
12,60,720,124,112,0.5709100944206993,0.355688373055443,0.2,0
23,66,1518,104,81,0.5700931052073412,0.5215329998983599,0.3484848484848485,0
11,56,616,107,96,0.5541343761307449,0.6582216684033201,0.19642857142857142,0
13,57,741,107,94,0.5540518187050895,0.6517899671534916,0.22807017543859648,0
12,62,744,128,116,0.5915115959027526,0.30394270093753517,0.1935483870967742,0
17,59,1003,135,118,0.5319477706063287,0.4476169211757715,0.288135593220339,0
18,58,1044,135,117,0.5534585672795527,0.42061707480736255,0.3103448275862069,0
25,151,3775,135,110,0.5793373307417684,0.4257435157760697,0.16556291390728478,0
22,130,2860,105,83,0.7802545473685264,0.16122906205784687,0.16923076923076924,0
70,574,40180,98,28,0.6390660423870057,0.531039567425578,0.12195121951219512,0
12,84,1008,133,121,0.5279100865690255,0.16888815305273316,0.14285714285714285,0
26,115,2990,65,39,0.6763153382726235,0.5862857478800214,0.22608695652173913,0
13,71,923,133,120,0.4923903740899168,0.16428588504181438,0.18309859154929578,0
20,89,1780,134,114,0.486050370452594,0.28169567819283486,0.2247191011235955,0
16,104,1664,137,121,0.4571913752644968,0.15591150860863093,0.15384615384615385,0
12,58,696,125,113,0.5080884873867428,0.17913194149074388,0.20689655172413793,0
20,71,1420,136,116,0.4509139509511803,0.0909851713652342,0.28169014084507044,0
28,66,1848,135,107,0.4793271575709694,0.22844533408155254,0.42424242424242425,0
15,49,735,112,97,0.4530878396793873,0.0,0.30612244897959184,0
31,236,7316,138,107,0.6207265522539408,0.37018876399523276,0.13135593220338984,0
17,114,1938,137,120,0.48251135769818604,0.3277882166962596,0.14912280701754385,0
16,94,1504,136,120,0.46491351064016945,0.35374203909574503,0.1702127659574468,0
16,59,944,126,110,0.48867109408239834,0.3750420036574326,0.2711864406779661,0
13,71,923,134,121,0.5171721951145744,0.39728736124597147,0.18309859154929578,0
13,79,1027,135,122,0.42775151870858474,0.2423100948185275,0.16455696202531644,0
13,47,611,93,80,0.5101083436867274,0.0,0.2765957446808511,0
14,47,658,117,103,0.4821088836141483,0.11804786917485013,0.2978723404255319,0
16,57,912,63,47,0.4995107272056389,0.1362183642411674,0.2807017543859649,0
17,64,1088,63,46,0.6640692785097638,0.5514780075608894,0.265625,0
49,561,27489,137,88,0.6025620567877139,0.5598852584152062,0.0873440285204991,0
36,576,20736,139,103,0.5302672081435216,0.28097155978310495,0.0625,0
20,91,1820,137,117,0.49960158448895325,0.4038669585997524,0.21978021978021978,0
19,88,1672,136,117,0.4966177690125752,0.21811337612485032,0.2159090909090909,0
38,142,5396,129,91,0.4973795206002495,0.0,0.2676056338028169,0
16,60,960,127,111,0.506039270795088,0.33915718973320846,0.26666666666666666,0
15,78,1170,107,92,0.5823127544738254,0.0,0.19230769230769232,0
28,118,3304,136,108,0.54176804272478,0.15376633103445356,0.23728813559322035,0
34,426,14484,121,87,0.5297913565496429,0.28390021660888554,0.07981220657276995,0
25,147,3675,114,89,0.524722654684043,0.49595984065483883,0.17006802721088435,0
28,98,2744,114,86,0.4996206071786995,0.3944473098851853,0.2857142857142857,0
10,70,700,177,167,0.8837734460027944,0.2657371023035254,0.14285714285714285,0
13,61,793,131,118,0.5617761088308869,0.5702752995756968,0.21311475409836064,0
0,0,0,0,0,0.0,0.0,0.0,0
0,0,0,0,0,0.0,0.0,0.0,0
32,733,23456,70,38,0.5476705486762511,0.4264221948851641,0.04365620736698499,0
18,56,1008,65,47,0.6254864140475639,0.6057898696563289,0.32142857142857145,0
15,53,795,104,89,0.5329732377780892,0.14444504930829605,0.2830188679245283,0
14,76,1064,125,111,0.6042027344990986,0.4319011252194013,0.18421052631578946,0
42,553,23226,75,33,0.5792708086474757,0.45683314356393917,0.0759493670886076,0
124,475,58900,155,31,0.6516324962281053,0.2623502047646214,0.26105263157894737,0
16,102,1632,124,108,1.2650312846797,0.9314333360238558,0.1568627450980392,0
17,98,1666,120,103,0.7422869480211369,0.3439403771371981,0.17346938775510204,0
0,0,0,0,0,0.0,0.0,0.0,0
0,0,0,0,0,0.0,0.0,0.0,0
0,0,0,0,0,0.0,0.0,0.0,0
23,95,2185,127,104,0.8949146858851622,0.6950032257672041,0.24210526315789474,0
0,0,0,0,0,0.0,0.0,0.0,0
0,0,0,0,0,0.0,0.0,0.0,0
12,79,948,61,49,0.550805491219224,0.3576886644662502,0.1518987341772152,0
12,61,732,104,92,0.6232701801931941,0.4587874303543391,0.19672131147540983,0
13,58,754,96,83,0.5417403014548672,0.532743570354715,0.22413793103448276,0
24,164,3936,112,88,0.5480817981517906,0.5162670444523773,0.14634146341463414,0
15,88,1320,132,117,0.5124702232775501,0.30404315386671116,0.17045454545454544,0
31,474,14694,118,87,0.5276996584882636,0.3648726205316419,0.06540084388185655,0
30,144,4320,132,102,0.5228206418156638,0.28126317009514257,0.20833333333333334,0
52,1073,55796,138,86,0.5232849991416386,0.12656708289083451,0.048462255358807084,0
50,126,6300,137,87,0.5894357384092938,0.42727266025055594,0.3968253968253968,0
22,112,2464,133,111,0.6984596241569876,0.6019521557052069,0.19642857142857142,0
33,825,27225,135,102,0.5259025427742418,0.20833173955332754,0.04,0
38,385,14630,138,100,0.46677990614041487,0.1962060376983188,0.0987012987012987,0
13,57,741,98,85,0.5103135874037557,0.0,0.22807017543859648,0
24,58,1392,67,43,0.48114454084618924,0.042415054926521846,0.41379310344827586,0
11,57,627,132,121,0.5234948727101806,0.26218098488016955,0.19298245614035087,0
17,62,1054,137,120,0.47977301831983593,0.3271106326026695,0.27419354838709675,0
13,53,689,122,109,0.48583294448835534,0.3506134706666014,0.24528301886792453,0
10,64,640,137,127,0.4930794059997431,0.17572037654713774,0.15625,0
16,45,720,112,96,0.49408038684863975,0.0,0.35555555555555557,0
26,112,2912,67,41,0.504130917069567,0.1836373429980811,0.23214285714285715,0
32,646,20672,63,31,0.9279561664622297,0.9256639751480567,0.04953560371517028,0
23,121,2783,133,110,0.7059891056151076,0.6705047141928925,0.19008264462809918,0
0,0,0,0,0,0.0,0.0,0.0,0
13,60,780,103,90,0.7830705668559756,0.7471345937947939,0.21666666666666667,0
34,169,5746,121,87,0.8223350822079508,0.7189595802783773,0.20118343195266272,0
0,0,0,0,0,0.0,0.0,0.0,0
0,0,0,0,0,0.0,0.0,0.0,0
31,1245,38595,111,80,0.729032886530166,0.7418620608880462,0.024899598393574297,0
0,0,0,0,0,0.0,0.0,0.0,0
0,0,0,0,0,0.0,0.0,0.0,0
0,0,0,0,0,0.0,0.0,0.0,0
44,658,28952,130,86,0.9619946601474737,0.9622595125675621,0.0668693009118541,0
11,59,649,128,117,0.7291857875386266,0.7950841134945792,0.1864406779661017,0
24,88,2112,122,98,0.7880360433009781,0.42338464059056286,0.2727272727272727,0
15,107,1605,132,117,0.7171575953292014,0.6373723817690354,0.14018691588785046,0
14,57,798,133,119,0.5475253558689464,0.30582113590878507,0.24561403508771928,0
14,64,896,129,115,0.623910277483397,0.4785001375236681,0.21875,0
17,83,1411,136,119,0.6031570800290585,0.5320463700584003,0.20481927710843373,0
15,76,1140,133,118,0.6287239430775544,0.564025732295088,0.19736842105263158,0
22,60,1320,133,111,0.5562894552624466,0.5142480957243718,0.36666666666666664,0
15,63,945,129,114,0.5984641685522185,0.6437976929245666,0.23809523809523808,0
18,76,1368,135,117,0.6112768112770104,0.45268925179319364,0.23684210526315788,0
15,44,660,133,118,0.5898276150509736,0.4562885983988631,0.3409090909090909,0
16,85,1360,135,119,0.6767196511097443,0.5717851461566631,0.18823529411764706,0
16,83,1328,137,121,0.5729002737094301,0.42805103813588286,0.1927710843373494,0
43,385,16555,135,92,0.5688083384577143,0.48486087243275205,0.11168831168831168,0
24,93,2232,119,95,0.558290007845924,0.28995099628601967,0.25806451612903225,0
32,211,6752,137,105,0.4845047487129414,0.10408087144796963,0.15165876777251186,0
16,63,1008,130,114,0.5482750481442098,0.09113026094645679,0.25396825396825395,0
17,110,1870,133,116,0.5424850755527367,0.35849936281350997,0.15454545454545454,0
25,134,3350,64,39,0.4992210821835464,0.20342167700294586,0.1865671641791045,0
16,71,1136,134,118,0.48164447339595345,0.22446527985903697,0.22535211267605634,0
11,60,660,131,120,0.513479775598793,0.33432014253204434,0.18333333333333332,0
17,92,1564,136,119,0.4870797985675656,0.20775652358141103,0.18478260869565216,0
24,122,2928,135,111,0.5320091042524105,0.27112708821327086,0.19672131147540983,0
12,77,924,138,126,0.5406244993032734,0.4056140796863129,0.15584415584415584,0
20,74,1480,64,44,0.483245422250885,0.2005100382873734,0.2702702702702703,0
34,383,13022,146,112,0.4419158592084191,0.1753719308499606,0.08877284595300261,0
16,67,1072,134,118,0.5030463974208312,0.38128933496733797,0.23880597014925373,0
23,50,1150,107,84,0.49943803431840744,0.0,0.46,0
17,80,1360,105,88,0.5306292630623605,0.3595027907171264,0.2125,0
70,406,28420,137,67,0.5158885059447691,0.2714382370932283,0.1724137931034483,0
21,125,2625,135,114,0.5807304667231029,0.4374672433086055,0.168,0
15,62,930,131,116,0.6060823392176891,0.35306547669568245,0.24193548387096775,0
23,105,2415,64,41,0.5467370184613849,0.27791223749438904,0.21904761904761905,0
15,93,1395,131,116,0.5359636428998001,0.2811939961027259,0.16129032258064516,0
14,93,1302,134,120,0.5455679637054394,0.4126053076017237,0.15053763440860216,0
0,0,0,0,0,0.0,0.0,0.0,0
0,0,0,0,0,0.0,0.0,0.0,0
41,851,34891,137,96,0.5967384986878413,0.4137889300967538,0.0481786133960047,0
13,71,923,118,105,0.6547141936914577,0.15162861089299995,0.18309859154929578,0
13,59,767,132,119,0.6338835715382549,0.5788972582925693,0.22033898305084745,0
14,75,1050,133,119,0.6159818503866406,0.44878068546085736,0.18666666666666668,0
12,62,744,97,85,0.6401343524522707,0.4942909865447036,0.1935483870967742,0
14,67,938,134,120,0.6816630321839044,0.5409619525511841,0.208955223880597,0
16,64,1024,64,48,0.5980410667219476,0.4758065250060284,0.25,0
20,96,1920,108,88,0.5675767575815421,0.5677484051049733,0.20833333333333334,0
26,159,4134,137,111,0.5574320889993617,0.4181821497447034,0.16352201257861634,0
31,515,15965,136,105,0.6095799887420409,0.4358385478067485,0.06019417475728155,0
20,71,1420,109,89,0.5266936746390929,0.48862787356321696,0.28169014084507044,0
29,94,2726,130,101,0.5124428063873597,0.2751616096928871,0.30851063829787234,0
11,74,814,138,127,0.48394606575123866,0.20531137700636298,0.14864864864864866,0
17,74,1258,136,119,0.5071369543479503,0.3502816047886753,0.22972972972972974,0
28,126,3528,115,87,0.507159224332428,0.3889345821236673,0.2222222222222222,0
31,204,6324,133,102,0.5072383901455196,0.33534332088339563,0.15196078431372548,0
28,114,3192,132,104,0.5069398108936918,0.2528104106291731,0.24561403508771928,0
56,294,16464,136,80,0.5280006031041798,0.45272754181744834,0.19047619047619047,0
48,166,7968,131,83,0.4568939724642272,0.2667693685871368,0.2891566265060241,0
17,93,1581,136,119,0.5106471707361139,0.17984429452442344,0.1827956989247312,0
38,102,3876,120,82,0.4871651221141896,0.31780822785080803,0.37254901960784315,0
36,111,3996,118,82,0.4750363471960692,0.35268897936712085,0.32432432432432434,0
25,64,1600,112,87,0.47641441752564806,0.45819176178552584,0.390625,0
22,75,1650,103,81,0.4963067410423501,0.509908168696082,0.29333333333333333,0
14,55,770,122,108,0.5808427269380756,0.3770082046256051,0.2545454545454545,0
24,136,3264,105,81,0.5559676642146311,0.5487064418791449,0.17647058823529413,0
45,76,3420,137,92,0.6178831725757384,0.43504725145455847,0.5921052631578947,0
22,132,2904,133,111,0.5430661025387281,0.36880313797400643,0.16666666666666666,0
30,148,4440,105,75,0.5180998054794334,0.4596890198863851,0.20270270270270271,0
31,145,4495,113,82,0.5471928716806033,0.43410821210438777,0.21379310344827587,0
24,103,2472,127,103,0.5201780161406079,0.2799298949833986,0.23300970873786409,0
33,182,6006,115,82,0.4916897685452886,0.43241612756052783,0.1813186813186813,0
43,286,12298,123,80,0.5144081325669774,0.44710187696246273,0.15034965034965034,0
14,78,1092,99,85,0.5198302175480921,0.5752453803220364,0.1794871794871795,0
18,52,936,118,100,0.5255213736122416,0.43528856577555625,0.34615384615384615,0
15,46,690,122,107,0.4787936429393503,0.1746518495546458,0.32608695652173914,0
24,161,3864,105,81,0.5738849957069139,0.4477332427221371,0.14906832298136646,0
24,56,1344,112,88,0.4945937675086775,0.41840427478377923,0.42857142857142855,0
31,429,13299,111,80,0.8257194976314445,0.6781165240928915,0.07226107226107226,0
12,66,792,96,84,0.5880734959258571,0.32448500030340754,0.18181818181818182,0
31,535,16585,111,80,0.6747309729968011,0.5950330746841684,0.05794392523364486,0
0,0,0,0,0,0.0,0.0,0.0,0
0,0,0,0,0,0.0,0.0,0.0,0
0,0,0,0,0,0.0,0.0,0.0,0
18,114,2052,136,118,0.5811485352738047,0.3263807367752365,0.15789473684210525,0
16,52,832,134,118,0.6350654537241209,0.5565674182644722,0.3076923076923077,0
44,412,18128,130,86,0.6220020212897182,0.47698024770784064,0.10679611650485436,0
16,72,1152,134,118,0.5472957784757101,0.4253418191994197,0.2222222222222222,0
0,0,0,0,0,0.0,0.0,0.0,0
14,56,784,137,123,0.6148159421294275,0.5606101528411598,0.25,0
0,0,0,0,0,0.0,0.0,0.0,0
16,92,1472,130,114,0.6198485043585963,0.5299577334302638,0.17391304347826086,0
12,85,1020,94,82,0.6351430412003418,0.7856358255487208,0.1411764705882353,0
17,60,1020,107,90,0.6657432432240636,0.06838410431104049,0.2833333333333333,0
13,54,702,128,115,0.5888220062212732,0.41961468829538323,0.24074074074074073,0
18,67,1206,135,117,0.5924938071848694,0.4906771469201446,0.26865671641791045,0
0,0,0,0,0,0.0,0.0,0.0,0
23,79,1817,108,85,0.524480505481751,0.05106385672416127,0.2911392405063291,0
14,57,798,133,119,0.6245293961584727,0.6654590663199206,0.24561403508771928,0
11,68,748,59,48,0.6097178165365745,0.34677116957125387,0.16176470588235295,0
0,0,0,0,0,0.0,0.0,0.0,0
12,60,720,129,117,0.5730779989219781,0.4587074588117838,0.2,0
12,80,960,131,119,0.7212235097125257,0.6619125994219798,0.15,0
15,101,1515,62,47,0.6673471554096885,0.46137268568256423,0.1485148514851485,0
13,73,949,61,48,0.638790250750823,0.29488391230980104,0.1780821917808219,0
0,0,0,0,0,0.0,0.0,0.0,0
22,98,2156,105,83,0.7916957105750176,0.5849343275781033,0.22448979591836735,0
11,59,649,98,87,0.7344652183373828,0.69842211250272,0.1864406779661017,0
13,92,1196,95,82,0.7109604200081898,0.6582334658765657,0.14130434782608695,0
0,0,0,0,0,0.0,0.0,0.0,0
12,76,912,94,82,0.6089822573250556,0.6770623165088824,0.15789473684210525,0
0,0,0,0,0,0.0,0.0,0.0,0
0,0,0,0,0,0.0,0.0,0.0,0
0,0,0,0,0,0.0,0.0,0.0,0
0,0,0,0,0,0.0,0.0,0.0,0
14,49,686,63,49,0.5506228231237073,0.27032549972595615,0.2857142857142857,0
13,86,1118,130,117,0.614096921641617,0.38879721666170414,0.1511627906976744,0
14,75,1050,65,51,0.6671923068653396,0.4870513458829094,0.18666666666666668,0
11,63,693,104,93,0.5676228770483804,0.0,0.1746031746031746,0
22,72,1584,131,109,0.655429037781129,0.22317455064635347,0.3055555555555556,0
39,205,7995,135,96,0.5848867228059274,0.2938811075545901,0.1902439024390244,0
13,61,793,179,166,1.2647681562473183,0.30449205581860606,0.21311475409836064,0
31,181,5611,134,103,1.0552009289601394,0.4773839759043817,0.1712707182320442,0
13,65,845,132,119,0.6730408002816549,0.5169503786830517,0.2,0
47,438,20586,75,28,0.7421458078189093,0.5540791235119161,0.10730593607305935,0
22,126,2772,104,82,0.8983860141548091,0.48664536921138746,0.1746031746031746,0
0,0,0,0,0,0.0,0.0,0.0,0
0,0,0,0,0,0.0,0.0,0.0,0
13,52,676,94,81,0.8791235986878538,0.7725617224078652,0.25,0
0,0,0,0,0,0.0,0.0,0.0,0
0,0,0,0,0,0.0,0.0,0.0,0
16,63,1008,65,49,0.658673647238151,0.6920014904404135,0.25396825396825395,0
0,0,0,0,0,0.0,0.0,0.0,0
36,611,21996,119,83,0.4678623938436278,0.04147305448889406,0.058919803600654665,0
34,549,18666,115,81,0.763944342895329,0.6372727157166709,0.061930783242258654,0
20,100,2000,104,84,1.055539325157906,0.853119114690172,0.2,0
14,60,840,65,51,0.9436917310317642,0.37237347368353135,0.23333333333333334,0
20,142,2840,130,110,0.7314344098318336,0.639053312012107,0.14084507042253522,0
14,72,1008,65,51,0.903002355610783,0.6859125075464578,0.19444444444444445,0
17,120,2040,134,117,0.686238560587036,0.6810394595299035,0.14166666666666666,0
18,72,1296,99,81,0.683551728096881,0.3979854884256133,0.25,0
22,98,2156,113,91,0.6508808575133613,0.5840533932799372,0.22448979591836735,0
38,721,27398,132,94,0.77862855791251,0.6690725574956499,0.052704576976421634,0
17,48,816,102,85,0.6382418297189245,0.5743665268941986,0.3541666666666667,0
16,87,1392,131,115,0.6616226353324794,0.610680753724744,0.1839080459770115,0
14,88,1232,132,118,0.6416795253921169,0.6936755910974302,0.1590909090909091,0
13,47,611,128,115,0.6055247060360975,0.449078799043227,0.2765957446808511,0
14,56,784,129,115,0.6633861849135451,0.5010233451607365,0.25,0
36,88,3168,187,151,0.7401111195215332,0.28385792429537904,0.4090909090909091,1
31,365,11315,139,108,0.604844918770877,0.34933654582383966,0.08493150684931507,0
14,62,868,88,74,0.6086320830643104,0.4242425956636638,0.22580645161290322,0
15,56,840,109,94,0.5602700322353101,0.23748854783924303,0.26785714285714285,0
12,57,684,135,123,0.5818288356330471,0.40224176412152934,0.21052631578947367,0
20,53,1060,132,112,0.5558734291522758,0.2528645067315575,0.37735849056603776,0
15,67,1005,137,122,0.5623480381322383,0.39571363868211656,0.22388059701492538,0
22,153,3366,136,114,0.47537689912526876,0.21844352908891046,0.1437908496732026,0
11,62,682,64,53,0.4779595347630153,0.06584915085180508,0.1774193548387097,0
22,71,1562,135,113,0.5067410092113495,0.02988738726989589,0.30985915492957744,0
11,74,814,133,122,0.48614574781038067,0.3951377281099088,0.14864864864864866,0
32,59,1888,124,92,0.4926232714192391,0.0,0.5423728813559322,0
18,76,1368,130,112,0.4859154670442058,0.3380619969236996,0.23684210526315788,0
38,191,7258,126,88,0.4876126255451455,0.0,0.19895287958115182,0
21,60,1260,132,111,0.48008806515528113,0.3591232626616569,0.35,0
22,139,3058,133,111,0.48468302418593107,0.2690384353763178,0.15827338129496402,0
10,68,680,177,167,0.673372347999133,0.2626228977798002,0.14705882352941177,0
19,83,1577,131,112,0.48037014036819226,0.17251246033569426,0.2289156626506024,0
16,85,1360,130,114,0.49729126996180983,0.39674627661164924,0.18823529411764706,0
16,43,688,121,105,0.4815452501203918,0.13687193770120157,0.37209302325581395,0
14,97,1358,104,90,0.5686916561427089,0.0,0.14432989690721648,0
11,60,660,114,103,0.5582926659379812,0.42445061842752346,0.18333333333333332,0
17,114,1938,106,89,0.5811771100268592,0.5564498430247341,0.14912280701754385,0
13,82,1066,101,88,0.6060232584687458,0.5160240998149299,0.15853658536585366,0
17,93,1581,105,88,0.5939308885622792,0.3735133810942199,0.1827956989247312,0
17,85,1445,108,91,0.5289494281273083,0.1343452505730039,0.2,0
22,111,2442,67,45,0.6024594397835152,0.4508805341782486,0.1981981981981982,0
12,81,972,121,109,0.4606934328506152,0.14361770945970015,0.14814814814814814,0
23,52,1196,76,53,0.5238440027762719,0.3013694389184851,0.4423076923076923,0
10,68,680,103,93,0.5978562685605601,0.0,0.14705882352941177,0
0,0,0,0,0,0.0,0.0,0.0,0
27,61,1647,113,86,0.5724687101159519,0.0,0.4426229508196721,0
0,0,0,0,0,0.0,0.0,0.0,0
18,66,1188,111,93,0.5348471343506782,0.3391100410971693,0.2727272727272727,0
13,66,858,65,52,0.7705759594811936,0.7503240454671029,0.19696969696969696,0
0,0,0,0,0,0.0,0.0,0.0,0
0,0,0,0,0,0.0,0.0,0.0,0
14,47,658,63,49,0.6510882324461993,0.6925048125067419,0.2978723404255319,0
0,0,0,0,0,0.0,0.0,0.0,0
0,0,0,0,0,0.0,0.0,0.0,0
31,612,18972,127,96,0.6579421784300304,0.40829113363479996,0.05065359477124183,0
0,0,0,0,0,0.0,0.0,0.0,0
0,0,0,0,0,0.0,0.0,0.0,0
17,79,1343,60,43,0.6739307633872553,0.6342819962452446,0.21518987341772153,0
0,0,0,0,0,0.0,0.0,0.0,0
0,0,0,0,0,0.0,0.0,0.0,0
0,0,0,0,0,0.0,0.0,0.0,0
16,111,1776,127,111,0.7101302913500449,0.47809750821708225,0.14414414414414414,0
20,117,2340,128,108,1.085240822922128,0.9055923345145531,0.17094017094017094,0
0,0,0,0,0,0.0,0.0,0.0,0
0,0,0,0,0,0.0,0.0,0.0,0
0,0,0,0,0,0.0,0.0,0.0,0
11,67,737,129,118,0.6681580695517494,0.5943832675796196,0.16417910447761194,0
0,0,0,0,0,0.0,0.0,0.0,0
0,0,0,0,0,0.0,0.0,0.0,0
16,81,1296,135,119,0.5290295260636266,0.4086092724466576,0.19753086419753085,0
16,53,848,136,120,0.5401704271918648,0.304609003464135,0.3018867924528302,0
29,94,2726,134,105,0.49125196800472687,0.3050671935789178,0.30851063829787234,0
15,92,1380,115,100,0.5229861934857207,0.4381629607006463,0.16304347826086957,0
29,98,2842,139,110,0.5352162675528823,0.404530903921649,0.29591836734693877,0
10,66,660,127,117,0.5841706534246633,0.45436986115709643,0.15151515151515152,0
16,91,1456,107,91,0.5310193566618268,0.0,0.17582417582417584,0
18,96,1728,137,119,0.5313101549448078,0.2253703940835297,0.1875,0
18,76,1368,135,117,0.46032583891056134,0.09410197826745191,0.23684210526315788,0
17,59,1003,137,120,0.5127644102870629,0.235214988784824,0.288135593220339,0
14,77,1078,136,122,0.48229514105885135,0.25401959688194686,0.18181818181818182,0
22,143,3146,136,114,0.47072497049383005,0.14926609903465488,0.15384615384615385,0
16,102,1632,138,122,0.48744804032630257,0.0,0.1568627450980392,0
32,180,5760,138,106,0.7260986845774745,0.43127188907197606,0.17777777777777778,0
19,114,2166,133,114,0.5116034628345567,0.2781731844740897,0.16666666666666666,0
15,65,975,136,121,0.49789003604648613,0.17706924514954211,0.23076923076923078,0
17,72,1224,137,120,0.526485019510954,0.21391057027266033,0.2361111111111111,0
15,93,1395,136,121,0.4779603513192537,0.25090383905208546,0.16129032258064516,0
24,124,2976,138,114,0.4350955182160901,0.0,0.1935483870967742,0
18,79,1422,137,119,0.539121504722358,0.29378415369081595,0.22784810126582278,0
25,72,1800,138,113,0.4561304829944018,0.13633140069126065,0.3472222222222222,0
17,112,1904,138,121,0.4935412674415757,0.4021033886715069,0.15178571428571427,0
19,86,1634,138,119,0.5397325183793693,0.3996597829435709,0.22093023255813954,0
28,120,3360,138,110,0.4692204645834578,0.02765187378901881,0.23333333333333334,0
35,119,4165,136,101,0.5376638228095744,0.2280347518794574,0.29411764705882354,0
34,302,10268,138,104,0.6992332603349354,0.46716288842224557,0.11258278145695365,0
26,51,1326,121,95,0.49879269338867016,0.283334560284124,0.5098039215686274,0
43,224,9632,89,46,0.5461758738994344,0.43319686714465294,0.19196428571428573,0
16,41,656,136,120,0.5271677569006392,0.23630380262196624,0.3902439024390244,0
0,0,0,0,0,0.0,0.0,0.0,0
10,67,670,178,168,0.6251489817915423,0.3153170842291317,0.14925373134328357,0
42,147,6174,71,29,0.4752380291518209,0.2048266832009061,0.2857142857142857,0
23,115,2645,131,108,0.7185647827151636,0.44962854922360374,0.2,0
23,68,1564,110,87,0.5673897172183244,0.1174605569063339,0.3382352941176471,0
16,98,1568,136,120,0.5053205096799325,0.1351090716279118,0.16326530612244897,0
19,128,2432,65,46,0.6788966191304925,0.6061615301514205,0.1484375,0
15,69,1035,65,50,0.6774918282183565,0.49741017310904634,0.21739130434782608,0
43,304,13072,127,84,0.9187243952631895,0.9229786442229472,0.14144736842105263,0
0,0,0,0,0,0.0,0.0,0.0,0
13,60,780,59,46,0.9023940782450047,0.9387139273856405,0.21666666666666667,0
0,0,0,0,0,0.0,0.0,0.0,0
0,0,0,0,0,0.0,0.0,0.0,0
14,57,798,60,46,0.9809742157380776,0.9971633988151987,0.24561403508771928,0
0,0,0,0,0,0.0,0.0,0.0,0
0,0,0,0,0,0.0,0.0,0.0,0
0,0,0,0,0,0.0,0.0,0.0,0
0,0,0,0,0,0.0,0.0,0.0,0
0,0,0,0,0,0.0,0.0,0.0,0
0,0,0,0,0,0.0,0.0,0.0,0
16,102,1632,99,83,0.8753456485637046,0.902799887883111,0.1568627450980392,0
0,0,0,0,0,0.0,0.0,0.0,0
0,0,0,0,0,0.0,0.0,0.0,0
19,91,1729,110,91,0.6180776427611407,0.5695660826639256,0.2087912087912088,0
20,74,1480,65,45,0.6499956507649473,0.2916511642224191,0.2702702702702703,0
12,59,708,59,47,0.6454560832359575,0.3942493263671079,0.2033898305084746,0
13,82,1066,64,51,0.6226998165937186,0.4235462789810373,0.15853658536585366,0
13,71,923,104,91,0.5614092417159257,0.013354827056869106,0.18309859154929578,0
18,78,1404,108,90,0.5532346501955048,0.18662695224473477,0.23076923076923078,0
14,93,1302,134,120,0.545554004347224,0.25455423453847903,0.15053763440860216,0
23,119,2737,134,111,0.5901473629357643,0.35397461699959665,0.19327731092436976,0
14,73,1022,132,118,0.5568175407663674,0.5196369962165264,0.1917808219178082,0
17,91,1547,132,115,0.5601971707987409,0.3126289567061278,0.18681318681318682,0
15,76,1140,134,119,0.5355883018779966,0.294392556509863,0.19736842105263158,0
20,96,1920,132,112,0.562116253415519,0.4890538759436485,0.20833333333333334,0
17,43,731,128,111,0.4868904756913544,0.22389958455852083,0.3953488372093023,0
41,53,2173,122,81,0.47014505836496084,0.1041023422433949,0.7735849056603774,0
24,62,1488,187,163,0.40949545468512605,0.0,0.3870967741935484,0
89,46,4094,187,98,0.32495873225140687,0.0,1.934782608695652,0
54,90,4860,187,133,0.3131065005749373,0.0,0.6,0
31,127,3937,187,156,0.3850088286279694,0.0,0.2440944881889764,0
129,62,7998,187,58,0.3796029569225323,0.0,2.0806451612903225,0
95,113,10735,187,92,0.3254800166031873,0.0,0.8407079646017699,0
45,48,2160,187,142,0.5080402039314169,0.0,0.9375,0
23,43,989,187,164,0.6903167199617186,0.09193874575714367,0.5348837209302325,0
16,66,1056,64,48,0.84024602302341,0.8510875824182317,0.24242424242424243,0
14,80,1120,59,45,0.7116088516559393,0.7694517862731887,0.175,0
16,108,1728,102,86,0.6898893078072678,0.6406154391822372,0.14814814814814814,0
42,691,29022,130,88,0.9881387223766781,1.0187637693712763,0.060781476121562955,0
17,93,1581,64,47,0.6956987207433083,0.5280357121757326,0.1827956989247312,0
13,59,767,118,105,0.7042935030322155,0.230614863676178,0.22033898305084745,0
23,82,1886,138,115,0.5566709107049285,0.26183299565479634,0.2804878048780488,0
14,88,1232,105,91,0.5764413109488888,0.04008478123399482,0.1590909090909091,0
14,87,1218,105,91,0.6263565974818527,0.047308837116492884,0.16091954022988506,0
18,87,1566,139,121,0.5574569157091173,0.4045353787528119,0.20689655172413793,0
18,116,2088,136,118,0.5205635633471276,0.1319197604862917,0.15517241379310345,0
18,70,1260,126,108,0.5557250891779772,0.2793786908573554,0.2571428571428571,0
14,71,994,125,111,0.5137150991242776,0.18329128511494946,0.19718309859154928,0
24,86,2064,67,43,0.5117945820172001,0.29638338343288817,0.27906976744186046,0
15,41,615,137,122,0.5225584742694421,0.368710784383668,0.36585365853658536,0
24,59,1416,130,106,0.4767549836454641,0.24420638178069276,0.4067796610169492,0
44,975,42900,133,89,0.5505401331894569,0.24133897342432742,0.04512820512820513,0
16,53,848,66,50,0.5257436521126814,0.24063462416714623,0.3018867924528302,0
26,42,1092,133,107,0.5121063770391885,0.43244156164038006,0.6190476190476191,0
25,77,1925,104,79,0.5730684263484627,0.0,0.3246753246753247,0
15,48,720,112,97,0.5021320341281287,0.2148405174060461,0.3125,0
46,703,32338,131,85,0.6546968491394699,0.47391546771906595,0.06543385490753911,0
29,54,1566,108,79,0.5255709906787368,0.2951648169602461,0.5370370370370371,0
0,0,0,0,0,0.0,0.0,0.0,0
23,152,3496,65,42,0.8209415835229162,0.7873976233335784,0.1513157894736842,0
16,56,896,130,114,0.6144831752142681,0.5697634590334296,0.2857142857142857,0
29,139,4031,116,87,0.6123499114998774,0.33385466993723073,0.20863309352517986,0
12,82,984,94,82,0.8553474614083986,0.7783964322435811,0.14634146341463414,0
43,763,32809,129,86,0.8575885289253637,0.8427949802592584,0.0563564875491481,0
16,98,1568,130,114,0.7569154970791806,0.6705466430712496,0.16326530612244897,0
24,134,3216,106,82,0.7555778955364411,0.5532022169184644,0.1791044776119403,0
10,61,610,129,119,0.7680244303779186,0.6476547355815906,0.16393442622950818,0
16,73,1168,130,114,0.5759599335158944,0.2978090374549362,0.2191780821917808,0
10,66,660,130,120,0.7596660440108954,0.647197491514255,0.15151515151515152,0
20,103,2060,106,86,0.654474283294159,0.6958493190491568,0.1941747572815534,0
29,158,4582,132,103,0.6248310685372512,0.47421436014364626,0.18354430379746836,0
46,183,8418,131,85,0.48476505624620303,0.31784803207437284,0.25136612021857924,0
19,95,1805,131,112,0.6192969210034318,0.4642410319755928,0.2,0
26,183,4758,134,108,0.5380799971401555,0.28886967158908,0.14207650273224043,0
16,69,1104,129,113,0.5423724104627627,0.35121402995026946,0.2318840579710145,0
17,85,1445,131,114,0.5346438720422698,0.3846713246032684,0.2,0
26,93,2418,137,111,0.5454569560550536,0.39134786718870856,0.27956989247311825,0
14,83,1162,127,113,0.5483002540183076,0.2621504574547384,0.1686746987951807,0
14,57,798,133,119,0.5038585103304585,0.3488350566896661,0.24561403508771928,0
32,444,14208,139,107,0.48195673971513187,0.19146123785539773,0.07207207207207207,0
40,259,10360,134,94,0.509217624812455,0.14436202365474457,0.15444015444015444,0
27,114,3078,137,110,0.6143292458049712,0.43909815032646204,0.23684210526315788,0
50,243,12150,138,88,0.6027765071374154,0.527875661924962,0.205761316872428,0
15,87,1305,133,118,0.5651508536465787,0.4560090291157587,0.1724137931034483,0
20,106,2120,131,111,0.4990541017452484,0.29566865951840693,0.18867924528301888,0
36,85,3060,123,87,0.4740526831940778,0.0,0.4235294117647059,0
18,77,1386,137,119,0.5308546112066783,0.20386543270779972,0.23376623376623376,0
10,71,710,136,126,0.5255737887607163,0.5107156982511943,0.14084507042253522,0
16,87,1392,135,119,0.5182995878051353,0.2827013768093785,0.1839080459770115,0
16,71,1136,131,115,0.5175368449091715,0.3122367497297825,0.22535211267605634,0
22,143,3146,132,110,0.5056792256082858,0.3552924733474607,0.15384615384615385,0
25,163,4075,134,109,0.5066783151869616,0.4256562433104771,0.15337423312883436,0
18,101,1818,136,118,0.5070102021597229,0.15203447762358913,0.1782178217821782,0
23,98,2254,133,110,0.43298678147901287,0.020374248554267047,0.23469387755102042,0
15,98,1470,134,119,0.5101509513962561,0.3704840217651004,0.15306122448979592,0
25,133,3325,136,111,0.48008633530196376,0.14324319883957942,0.18796992481203006,0
13,52,676,132,119,0.4822758865135328,0.30687595483427255,0.25,0
26,152,3952,134,108,0.5990495043068216,0.5065013717121677,0.17105263157894737,0
29,154,4466,137,108,0.49015652221136125,0.346944794671228,0.18831168831168832,0
18,68,1224,137,119,0.5531320375398946,0.28440228830934705,0.2647058823529412,0
16,61,976,129,113,0.7848489804863823,0.7304594197670236,0.26229508196721313,0
15,63,945,136,121,0.5626735024010122,0.3889762155971523,0.23809523809523808,0
15,84,1260,125,110,0.5254039597336922,0.2967794661165309,0.17857142857142858,0
37,236,8732,148,111,0.5679483628249651,0.3823480268978853,0.15677966101694915,0
14,49,686,134,120,0.5128068178963352,0.33219086652470686,0.2857142857142857,0
11,68,748,131,120,0.5657532222275589,0.40793868920800486,0.16176470588235295,0
27,67,1809,107,80,0.6834620043032482,0.17358821028954363,0.40298507462686567,0
19,98,1862,136,117,0.6066064050739535,0.501446058304005,0.19387755102040816,0
20,123,2460,137,117,0.48115559786607315,0.2513010001511908,0.16260162601626016,0
16,80,1280,133,117,0.511584658831339,0.3761881939538902,0.2,0
39,208,8112,137,98,0.47455984802879025,0.10966698233612973,0.1875,0
11,61,671,116,105,0.5423043129888006,0.11905832864244477,0.18032786885245902,0
16,56,896,131,115,0.5032985063461043,0.26779740540455377,0.2857142857142857,0
15,82,1230,125,110,0.49976262876854,0.3926970887389262,0.18292682926829268,0
45,141,6345,131,86,0.5549223326131468,0.49193095127549485,0.3191489361702128,0
22,75,1650,107,85,0.562115058981802,0.47626560262823486,0.29333333333333333,0
19,55,1045,105,86,0.5996509169208474,0.49468559877907636,0.34545454545454546,0
25,79,1975,111,86,0.7050770758984214,0.6251717321316487,0.31645569620253167,0
11,58,638,128,117,0.6022943884818496,0.3864601323444549,0.1896551724137931,0
16,71,1136,105,89,0.5767175852916447,0.47154713511009105,0.22535211267605634,0
20,92,1840,65,45,0.5753487284682679,0.20607280132246897,0.21739130434782608,0
20,113,2260,129,109,0.5795719419934914,0.4818237032107263,0.17699115044247787,0
25,141,3525,66,41,0.6298540605312987,0.494025958386339,0.1773049645390071,0
28,125,3500,110,82,0.5314880783488987,0.3334120880646354,0.224,0
10,63,630,140,130,0.5710830276381624,0.18451164944173576,0.15873015873015872,0
36,181,6516,123,87,0.4854940005049936,0.20759986790550938,0.19889502762430938,0
22,74,1628,65,43,0.751287845673032,0.3181812296294643,0.2972972972972973,0
15,52,780,138,123,0.5602480018011814,0.3451543685602033,0.28846153846153844,0
21,72,1512,66,45,0.5779192145420466,0.3772870513040085,0.2916666666666667,0
10,68,680,124,114,0.5199759098376173,0.33303969570215897,0.14705882352941177,0
11,55,605,187,176,0.6271387606377052,0.4371963444101752,0.2,1
36,316,11376,139,103,0.474583272326424,0.2236698108308467,0.11392405063291139,0
26,49,1274,127,101,0.47564955260054786,0.20494022352738123,0.5306122448979592,0
22,70,1540,124,102,0.5255646470443166,0.3385862767028504,0.3142857142857143,0
20,58,1160,64,44,0.5043311395640178,0.2965037994439565,0.3448275862068966,0
24,112,2688,134,110,0.6006455070962171,0.1755752450280684,0.21428571428571427,0
17,53,901,136,119,0.5368279852405785,0.2768035645039009,0.32075471698113206,0
37,337,12469,142,105,0.4758024360550011,0.24610484859331747,0.10979228486646884,0
30,104,3120,136,106,0.49499804979701323,0.2545311742777377,0.28846153846153844,0
15,43,645,130,115,0.48903774215945234,0.3851396384329778,0.3488372093023256,0
41,259,10619,121,80,0.5007742013251918,0.0,0.1583011583011583,0
15,79,1185,140,125,0.5019199092008237,0.35962187242165244,0.189873417721519,0
13,49,637,122,109,0.5246307750451279,0.34875768522458406,0.2653061224489796,0
12,51,612,105,93,0.5392505536224025,0.0,0.23529411764705882,0
29,129,3741,138,109,0.5137027726544491,0.31271995857726004,0.2248062015503876,0
18,72,1296,135,117,0.49964383114642574,0.28770302717960333,0.25,0
14,76,1064,125,111,0.5486355846927051,0.14936561098229661,0.18421052631578946,0
13,58,754,121,108,0.5392733460666463,0.18219736225423258,0.22413793103448276,0
26,126,3276,132,106,0.5378601218997168,0.35539151921415907,0.20634920634920634,0
15,69,1035,136,121,0.5101212417439159,0.42850606137798697,0.21739130434782608,0
23,81,1863,137,114,0.5256701156739527,0.3159620996881166,0.2839506172839506,0
19,127,2413,138,119,0.5651047450488977,0.4363911367109638,0.14960629921259844,0
13,88,1144,136,123,0.5713142350140051,0.4820275430824171,0.14772727272727273,0
14,48,672,187,173,0.5663365264739755,0.4603148109029325,0.2916666666666667,0
17,52,884,121,104,0.5274279206280736,0.2288564704354297,0.3269230769230769,0
24,119,2856,68,44,0.5799166157629461,0.3949564633662497,0.20168067226890757,0
25,64,1600,136,111,0.5794003694111491,0.4408112973284264,0.390625,0
15,82,1230,137,122,0.6139509658842568,0.49243405566832243,0.18292682926829268,0
24,137,3288,128,104,0.5606706003232997,0.37410893535378875,0.17518248175182483,0
23,127,2921,135,112,0.5635756046611808,0.375686865682117,0.18110236220472442,0
15,52,780,135,120,0.5831955873226926,0.33200792935975737,0.28846153846153844,0
15,92,1380,135,120,0.5670194128342736,0.5900563198975294,0.16304347826086957,0
16,48,768,134,118,0.5277573035320057,0.36647173517227016,0.3333333333333333,0
12,83,996,128,116,0.5169319984487125,0.23153942057946175,0.14457831325301204,0
13,74,962,133,120,0.483076834426519,0.28344203350999464,0.17567567567567569,0
11,58,638,67,56,0.5441515067391751,0.5388843138065906,0.1896551724137931,0
14,44,616,109,95,0.4945733417383058,0.0,0.3181818181818182,0
18,58,1044,136,118,0.5617326883804967,0.4408205707274838,0.3103448275862069,0
13,92,1196,117,104,0.5708340193307139,0.204953524479954,0.14130434782608695,0
17,61,1037,113,96,0.6040531937782949,0.2952511868593758,0.2786885245901639,0
15,101,1515,127,112,0.4760080164209285,0.39952012551574706,0.1485148514851485,0
35,28,980,135,100,0.6309784050751119,0.4655575686245651,1.25,0
16,63,1008,103,87,0.5347928833504163,0.3788288997436787,0.25396825396825395,0
0,0,0,0,0,0.0,0.0,0.0,0
39,817,31863,120,81,0.5108505430724884,0.24983537772689904,0.04773561811505508,0
15,56,840,65,50,0.567896368397927,0.4195642259836272,0.26785714285714285,0
18,75,1350,101,83,0.5918057646469634,0.3987742452224485,0.24,0
17,44,748,61,44,0.5737807104451891,0.44222592732090144,0.38636363636363635,0
12,70,840,67,55,0.6208470326036137,0.5823611127794062,0.17142857142857143,0
15,55,825,130,115,0.5576177210683727,0.43638028352225017,0.2727272727272727,0
22,58,1276,105,83,0.5673234268698574,0.17055520811042127,0.3793103448275862,0
44,622,27368,123,79,0.5904640977231979,0.3941374664800694,0.0707395498392283,0
21,84,1764,129,108,0.9630155113808779,0.6308309959030013,0.25,0
0,0,0,0,0,0.0,0.0,0.0,0
0,0,0,0,0,0.0,0.0,0.0,0
19,131,2489,65,46,0.6966690725096739,0.4984145700999462,0.1450381679389313,0
22,137,3014,66,44,0.687970058577883,0.6799628691607197,0.16058394160583941,0
15,54,810,118,103,0.5605753601997451,0.3415145093702799,0.2777777777777778,0
20,109,2180,110,90,0.49942522834975894,0.3919032423105356,0.1834862385321101,0
16,92,1472,131,115,0.6044166774924534,0.47373654835739404,0.17391304347826086,0
18,95,1710,126,108,0.5069931144713141,0.10192783983081628,0.18947368421052632,0
19,118,2242,135,116,0.5508762097311195,0.3932684936553172,0.16101694915254236,0
18,93,1674,137,119,0.5179405664759896,0.3704351431941903,0.1935483870967742,0
11,63,693,129,118,0.5565983436269321,0.2575265191141327,0.1746031746031746,0
28,172,4816,136,108,0.5260623488935372,0.30422061317035903,0.16279069767441862,0
30,175,5250,140,110,0.5460642027223215,0.30149317892482075,0.17142857142857143,0
14,83,1162,132,118,0.5194168955796549,0.10393171165446469,0.1686746987951807,0
18,72,1296,137,119,0.5812398884210725,0.3882496474698906,0.25,0
56,339,18984,139,83,0.559331906369945,0.3310302928608993,0.16519174041297935,0
16,44,704,137,121,0.49883432889688173,0.11367225132580701,0.36363636363636365,0
18,99,1782,134,116,0.5484592833165638,0.39716188867156244,0.18181818181818182,0
137,148,20276,187,50,0.5167946194509428,0.18737620634060315,0.9256756756756757,0
21,137,2877,133,112,0.4998031916248752,0.2843249914323131,0.15328467153284672,0
18,53,954,136,118,0.5081248555048375,0.33714093291947106,0.33962264150943394,0
17,58,986,137,120,0.5214805372404323,0.4293328954919426,0.29310344827586204,0
49,212,10388,137,88,0.5264469748469688,0.31080219722603464,0.23113207547169812,0
21,90,1890,136,115,0.5488842753920035,0.33771061439340133,0.23333333333333334,0
19,65,1235,133,114,0.5525607892589278,0.38998780822131174,0.2923076923076923,0
16,104,1664,130,114,0.5378048728304593,0.3307841932426498,0.15384615384615385,0
21,102,2142,140,119,0.501108388443299,0.2747086084210896,0.20588235294117646,0
18,62,1116,129,111,0.48204627429950864,0.02632652443023366,0.2903225806451613,0
12,77,924,120,108,0.5709292031810459,0.3576705039846674,0.15584415584415584,0
16,87,1392,119,103,0.529982411066734,0.21282769441597615,0.1839080459770115,0
119,104,12376,187,68,0.7812741353065147,0.27267474969886774,1.1442307692307692,0
16,79,1264,121,105,0.5132181646538594,0.11914655700404866,0.20253164556962025,0
12,84,1008,117,105,0.488066955672586,0.06658385824740692,0.14285714285714285,0
16,64,1024,128,112,0.575240888238695,0.46885132937463225,0.25,0
13,88,1144,131,118,0.5566985593577656,0.4752240372766137,0.14772727272727273,0
19,68,1292,131,112,0.5659320938185335,0.49170975636842645,0.27941176470588236,0
17,80,1360,130,113,0.543596642320631,0.39506469897377694,0.2125,0
11,77,847,117,106,0.5144751448914188,0.0,0.14285714285714285,0
25,73,1825,65,40,0.7177528794655437,0.4034107696066903,0.3424657534246575,0
11,74,814,123,112,0.6373846337777859,0.4236288211368866,0.14864864864864866,0
16,95,1520,97,81,0.8461355646872334,0.638547105022382,0.16842105263157894,0
84,203,17052,112,28,0.9420671270702861,0.5870229536754472,0.41379310344827586,0
10,68,680,129,119,0.6888943546199136,0.6159119533283739,0.14705882352941177,0
11,75,825,130,119,0.7073598983340695,0.5470553111180986,0.14666666666666667,0
22,63,1386,106,84,0.6762581945255787,0.40725653646348253,0.3492063492063492,0
14,75,1050,119,105,0.5715131606766243,0.5164519134270557,0.18666666666666668,0
13,86,1118,100,87,0.8625697120085517,0.8913306753260657,0.1511627906976744,0
0,0,0,0,0,0.0,0.0,0.0,0
0,0,0,0,0,0.0,0.0,0.0,0
39,538,20982,130,91,0.869983160781138,0.7393494359798792,0.0724907063197026,0
14,76,1064,56,42,0.8425969674346226,0.8739245813101049,0.18421052631578946,0
23,80,1840,112,89,0.8298444829324707,0.7064695629813633,0.2875,0
17,70,1190,62,45,0.8693110609284811,0.9486065930173773,0.24285714285714285,0
0,0,0,0,0,0.0,0.0,0.0,0
18,127,2286,66,48,0.8850116041725026,0.7504885317936013,0.14173228346456693,0
14,69,966,63,49,0.9430473236407871,0.9063153105412836,0.2028985507246377,0
44,490,21560,130,86,1.174508881359899,1.1735246100218453,0.08979591836734693,0
12,79,948,128,116,0.884984244669059,0.8864960343819648,0.1518987341772152,0
20,134,2680,63,43,0.9585618078193027,0.7814288579402804,0.14925373134328357,0
21,138,2898,64,43,0.8102802184349109,0.8344135961251093,0.15217391304347827,0
15,67,1005,104,89,0.7249803294584611,0.7095561070068716,0.22388059701492538,0
21,84,1764,64,43,0.999575463281582,0.934530607913744,0.25,0
32,186,5952,113,81,0.9701965118839894,0.8353720479084791,0.17204301075268819,0
15,67,1005,127,112,0.7580449485172028,0.6819141556158866,0.22388059701492538,0
11,71,781,128,117,0.8369647243848081,0.7069744757654387,0.15492957746478872,0
27,99,2673,142,115,0.5647157582055344,0.38477008144166014,0.2727272727272727,0
39,352,13728,153,114,0.7973478873657268,0.5415309852600546,0.11079545454545454,0
23,100,2300,125,102,0.5379481802584177,0.29994629533197825,0.23,0
18,57,1026,129,111,0.6492028057372218,0.41641383204197097,0.3157894736842105,0
32,329,10528,138,106,0.6258418400737235,0.2842994459660231,0.0972644376899696,0
20,98,1960,65,45,0.536240585317498,0.3609841420066589,0.20408163265306123,0
47,399,18753,140,93,0.6217933634488103,0.3693694915104973,0.11779448621553884,0
14,79,1106,136,122,0.6628961034976747,0.560819022448621,0.17721518987341772,0
20,95,1900,140,120,0.5830911786937594,0.4379253268778522,0.21052631578947367,0
27,61,1647,138,111,0.46601436920754646,0.2163112235184736,0.4426229508196721,0
18,120,2160,139,121,0.5202899338309538,0.42899720184548357,0.15,0
21,103,2163,137,116,0.5725727839656843,0.4514683890769313,0.20388349514563106,0
37,185,6845,137,100,0.46016023544506923,0.05032896438691088,0.2,0
13,82,1066,132,119,0.5539777505144904,0.4453232079585034,0.15853658536585366,0
25,47,1175,67,42,0.6587188446168444,0.4337546396477944,0.5319148936170213,0
22,73,1606,103,81,0.5736451326288194,0.5965556747485233,0.3013698630136986,0
36,378,13608,137,101,0.5165918847966141,0.2524963341792172,0.09523809523809523,0
20,138,2760,138,118,0.6592376371206172,0.48181265988058924,0.14492753623188406,0
21,150,3150,139,118,0.5336092293412975,0.4370510904950115,0.14,0
18,127,2286,138,120,0.5545227425968614,0.4275635493715326,0.14173228346456693,0
34,138,4692,119,85,0.5284654608545424,0.35818686356121904,0.2463768115942029,0
15,78,1170,137,122,0.5606538260389691,0.40198145385229583,0.19230769230769232,0
27,150,4050,137,110,0.5303480909717848,0.2961717138786905,0.18,0
53,199,10547,138,85,0.5669660107244788,0.4014198908706501,0.2663316582914573,0
24,94,2256,133,109,0.456836862395478,0.09967383805350848,0.2553191489361702,0
11,72,792,129,118,0.6395598407167821,0.4820182324440561,0.1527777777777778,0
18,96,1728,135,117,0.6110650155104357,0.539014458805315,0.1875,0
14,73,1022,125,111,0.5309599231857184,0.24663042310400182,0.1917808219178082,0
26,174,4524,137,111,0.4642425775215624,0.16306400857653489,0.14942528735632185,0
19,116,2204,67,48,0.5127186713917197,0.12695487814019749,0.16379310344827586,0
50,186,9300,129,79,0.48811938760143864,0.005649294326309199,0.26881720430107525,0
11,78,858,90,79,0.704369343563328,0.22226425659707016,0.14102564102564102,0
12,57,684,124,112,0.5305902219908754,0.12768483786145687,0.21052631578947367,0
15,78,1170,116,101,0.49584719595279847,0.0,0.19230769230769232,0
18,62,1116,137,119,0.4983917245114186,0.41879007034341675,0.2903225806451613,0
25,69,1725,110,85,0.8729345563595499,0.675943428453376,0.36231884057971014,0
44,263,11572,129,85,0.46349554630026224,0.0,0.16730038022813687,0
19,131,2489,122,103,0.5172167760747165,0.07677463845469662,0.1450381679389313,0
18,92,1656,123,105,0.5140382036272046,0.11450926328278536,0.1956521739130435,0
16,51,816,103,87,0.565057197081293,0.5714624545475981,0.3137254901960784,0
91,154,14014,134,43,0.549604188602544,0.09217050097367585,0.5909090909090909,0
13,75,975,103,90,0.6249402929229234,0.6341749902641861,0.17333333333333334,0
19,118,2242,104,85,0.6192127852551061,0.6288765283147104,0.16101694915254236,0
18,109,1962,104,86,0.6489298099130626,0.6666976009153527,0.1651376146788991,0
16,106,1696,102,86,0.5467514938406259,0.4963943392394638,0.1509433962264151,0
12,58,696,134,122,0.5575570443962731,0.521516475719905,0.20689655172413793,0
17,107,1819,132,115,0.5475785818840717,0.3965139178565063,0.1588785046728972,0
18,93,1674,103,85,0.6542703749435668,0.718683149067874,0.1935483870967742,0
11,66,726,132,121,0.566982404385319,0.5959017581109798,0.16666666666666666,0
36,209,7524,121,85,0.5863435831385908,0.3142909503301682,0.1722488038277512,0
37,124,4588,122,85,0.49806210560493225,0.23677380961768757,0.29838709677419356,0
28,83,2324,108,80,0.5954675494918337,0.46580631957828195,0.3373493975903614,0
15,52,780,116,101,0.6001203553553951,0.4367159797354078,0.28846153846153844,0
20,61,1220,105,85,0.7512010871982371,0.5692792936845145,0.32786885245901637,0
17,78,1326,99,82,0.6040697402449581,0.3903147000311873,0.21794871794871795,0
13,76,988,99,86,0.8517726773536499,0.7085121727628896,0.17105263157894737,0
24,46,1104,65,41,0.5639216128578498,0.4284261336993854,0.5217391304347826,0
11,58,638,128,117,0.6291396400389802,0.48473620201771384,0.1896551724137931,0
17,71,1207,127,110,0.6896734489467924,0.37363235887854074,0.23943661971830985,0
12,82,984,131,119,1.4956526777487735,0.9300983776892165,0.14634146341463414,0
52,443,23036,137,85,0.5339652434838118,0.27970467302556834,0.11738148984198646,0
23,85,1955,132,109,0.6959201782695441,0.4334443494398514,0.27058823529411763,0
19,135,2565,111,92,0.5713342854661875,0.36396227015525867,0.14074074074074075,0
15,83,1245,134,119,0.6077968887852068,0.5302702711839814,0.18072289156626506,0
16,113,1808,150,134,0.7763544638239503,0.6397417099039273,0.1415929203539823,0
14,62,868,131,117,0.6697340672652533,0.6996082325102373,0.22580645161290322,0
25,131,3275,131,106,0.540451959629647,0.41262638261252044,0.19083969465648856,0
36,320,11520,70,34,0.5223093925037555,0.11233788177854799,0.1125,0
30,88,2640,131,101,0.4752853399276943,0.12841933418945656,0.3409090909090909,0
15,49,735,126,111,0.47289358216153793,0.17505263037684674,0.30612244897959184,0
47,147,6909,140,93,0.48629935565782756,0.08583771969046071,0.3197278911564626,0
13,51,663,139,126,0.5059572895192338,0.37668508722147775,0.2549019607843137,0
15,52,780,134,119,0.5155506107575,0.2833457829077383,0.28846153846153844,0
16,99,1584,135,119,0.522227789256214,0.3867114190321912,0.16161616161616163,0
13,74,962,127,114,0.5080649485459594,0.2415809781697984,0.17567567567567569,0
14,75,1050,134,120,0.502961924433602,0.5046823072082687,0.18666666666666668,0
10,71,710,94,84,0.499424012855816,0.14941872809231252,0.14084507042253522,0
14,72,1008,136,122,0.4933746114115107,0.0020609184051900192,0.19444444444444445,0
27,181,4887,132,105,0.5814701502774694,0.29170706893238635,0.14917127071823205,0
21,56,1176,106,85,0.5009201262929146,0.037571667510942326,0.375,0
22,73,1606,135,113,0.45156581724156264,0.0,0.3013698630136986,0
14,51,714,126,112,0.4737809023945395,0.17783458782144496,0.27450980392156865,0
15,55,825,135,120,0.44271225968629796,0.07918850145486964,0.2727272727272727,0
35,277,9695,132,97,0.48383883141013295,0.058072118087744734,0.1263537906137184,0
43,610,26230,138,95,0.6053043342354433,0.4455867702929129,0.07049180327868852,0
23,159,3657,109,86,0.5866503852740312,0.5929030199618341,0.14465408805031446,0
17,112,1904,129,112,0.538900583938973,0.24594773806973433,0.15178571428571427,0
14,67,938,125,111,0.509096943151288,0.2662451723075765,0.208955223880597,0
45,124,5580,127,82,0.5481103607815211,0.012369323524879043,0.3629032258064516,0
11,61,671,123,112,0.5199311903887275,0.28790125943389233,0.18032786885245902,0
26,96,2496,109,83,0.8661484457561486,0.6079742470949128,0.2708333333333333,0
18,97,1746,112,94,0.5007364469444646,0.0,0.18556701030927836,0
25,96,2400,119,94,0.5173399991481817,0.20611497156848205,0.2604166666666667,0
30,140,4200,130,100,0.9109464837783873,0.4741139012528941,0.21428571428571427,0
18,40,720,120,102,0.4629982235192339,0.24876716272203112,0.45,0
15,50,750,112,97,0.5007558929927052,0.28410526154946286,0.3,0
11,61,671,120,109,0.5124603458129551,0.38870503454749755,0.18032786885245902,0
45,81,3645,130,85,0.5675073445996764,0.35791698306786046,0.5555555555555556,0
0,0,0,0,0,0.0,0.0,0.0,0
12,62,744,63,51,0.7021799968061513,0.6483665586112881,0.1935483870967742,0
0,0,0,0,0,0.0,0.0,0.0,0
17,51,867,105,88,0.8106195817842186,0.6383998210683695,0.3333333333333333,0
51,380,19380,131,80,0.6250535343369262,0.4272035899156021,0.13421052631578947,0
13,90,1170,57,44,0.6771744802279128,0.5604041528872751,0.14444444444444443,0
11,65,715,54,43,0.748979116053649,0.8108079842258198,0.16923076923076924,0
17,56,952,117,100,0.7335647598121818,0.5719451609799715,0.30357142857142855,0
35,773,27055,69,34,1.0429664546686106,1.069803309739732,0.045278137128072445,0
0,0,0,0,0,0.0,0.0,0.0,0
0,0,0,0,0,0.0,0.0,0.0,0
0,0,0,0,0,0.0,0.0,0.0,0
32,334,10688,65,33,0.725241564158099,0.4637362131220118,0.09580838323353294,0
0,0,0,0,0,0.0,0.0,0.0,0
0,0,0,0,0,0.0,0.0,0.0,0
15,67,1005,119,104,0.7235070793265269,0.4475467450747086,0.22388059701492538,0
23,100,2300,127,104,0.47564104937429486,0.21543468649276548,0.23,0
14,86,1204,129,115,0.5363315200407122,0.3325008153737806,0.16279069767441862,0
21,94,1974,129,108,0.6820928184620767,0.31189653103464354,0.22340425531914893,0
19,66,1254,122,103,0.5170651647648279,0.21868086341603846,0.2878787878787879,0
16,75,1200,58,42,0.5377893402247304,0.3153016848606434,0.21333333333333335,0
12,80,960,130,118,0.5380679668410394,0.3233816598049032,0.15,0
26,114,2964,133,107,0.5152588038485151,0.34366686900895105,0.22807017543859648,0
58,70,4060,187,129,0.6356689883120192,0.21357984566498558,0.8285714285714286,1
32,129,4128,130,98,0.6153833430025121,0.3970360228203466,0.24806201550387597,0
14,49,686,135,121,0.5527723556961192,0.44648367766089814,0.2857142857142857,0
52,698,36296,140,88,0.557725078166273,0.256196783324785,0.07449856733524356,0
20,122,2440,138,118,0.5302529324059065,0.411940853663555,0.16393442622950818,0
41,196,8036,134,93,0.45472165991375474,0.054428155921123635,0.20918367346938777,0
10,61,610,125,115,0.4792621793585531,0.33878912882122697,0.16393442622950818,0
19,75,1425,137,118,0.4659269288865132,0.24139391824990553,0.25333333333333335,0
24,56,1344,137,113,0.4588833984561838,0.0557175209561366,0.42857142857142855,0
23,162,3726,133,110,0.5221815473102818,0.35685285095168723,0.1419753086419753,0
13,89,1157,125,112,0.5262573661544886,0.3573766166128043,0.14606741573033707,0
19,33,627,132,113,0.48386060663398045,0.3664335038747753,0.5757575757575758,0
24,111,2664,135,111,0.4632149953100413,0.028507207099286617,0.21621621621621623,0
25,100,2500,135,110,0.46659690000923826,0.0,0.25,0
21,94,1974,133,112,0.44918290979284625,0.14295518281487246,0.22340425531914893,0
14,51,714,125,111,0.44397668622874004,0.2506001247600558,0.27450980392156865,0
14,54,756,120,106,0.4462210666491651,0.0,0.25925925925925924,0
14,54,756,132,118,0.4927551191588983,0.22382904466348733,0.25925925925925924,0
20,64,1280,131,111,0.46947192077761235,0.061810434574066944,0.3125,0
25,161,4025,132,107,0.5981069303049443,0.1243718231529876,0.15527950310559005,0
15,57,855,61,46,0.5084878162381433,0.24971252100215405,0.2631578947368421,0
33,852,28116,135,102,0.5186724102544762,0.21664747284290647,0.03873239436619718,0
62,676,41912,138,76,0.574820406661396,0.27734262598830894,0.09171597633136094,0
35,407,14245,129,94,0.5407982052036563,0.4341703612370818,0.085995085995086,0
33,93,3069,165,132,0.5911024796964816,0.3392148036318042,0.3548387096774194,0
37,136,5032,134,97,0.4733684468280814,0.22863383443957325,0.27205882352941174,0
18,67,1206,125,107,0.494349069492997,0.21046206128526665,0.26865671641791045,0
27,71,1917,131,104,0.4791677275513202,0.12767364409142049,0.38028169014084506,0
21,123,2583,69,48,0.475569545192744,0.3180097610526366,0.17073170731707318,0
15,57,855,107,92,0.559306241524253,0.0,0.2631578947368421,0
28,115,3220,115,87,0.5076950795686441,0.0,0.24347826086956523,0
23,63,1449,133,110,0.4939003653462191,0.32260646463916814,0.36507936507936506,0
0,0,0,0,0,0.0,0.0,0.0,0
24,59,1416,109,85,0.6161090732032775,0.26560689077188865,0.4067796610169492,0
35,1106,38710,129,94,0.7470211655841602,0.6747529980319771,0.03164556962025317,0
10,65,650,97,87,0.7908683681510432,0.7144544937611496,0.15384615384615385,0
0,0,0,0,0,0.0,0.0,0.0,0
22,87,1914,106,84,0.9963784599473269,0.7822452116792675,0.25287356321839083,0
61,283,17263,103,42,0.48868828785493407,0.2809006176687122,0.21554770318021202,0
30,151,4530,111,81,0.5369857478090535,0.36570708848493766,0.1986754966887417,0
33,257,8481,128,95,0.6714712464004068,0.6534814367088422,0.12840466926070038,0
11,63,693,104,93,0.8887084287081715,0.9577981448505121,0.1746031746031746,0
33,478,15774,67,34,0.7900282957365623,0.7624562225178931,0.06903765690376569,0
13,88,1144,127,114,0.8059732169743816,0.8330666962868154,0.14772727272727273,0
36,537,19332,119,83,0.8684130296017816,0.776509347497404,0.0670391061452514,0
43,629,27047,129,86,1.086643763236716,1.0042102284615197,0.06836248012718601,0
18,84,1512,66,48,0.6387104888134528,0.45082761065327354,0.21428571428571427,0
21,89,1869,65,44,0.6189641405318284,0.6454773460979351,0.23595505617977527,0
23,92,2116,64,41,0.6194072991371301,0.3677792115254346,0.25,0
24,117,2808,136,112,0.5507031714543495,0.43265307510065876,0.20512820512820512,0
18,57,1026,132,114,0.5640535612635332,0.232313409331124,0.3157894736842105,0
17,93,1581,136,119,0.5866539519245277,0.48234515966081243,0.1827956989247312,0
16,78,1248,137,121,0.5694043081704393,0.35227983526337575,0.20512820512820512,0
20,131,2620,130,110,0.5349937962297423,0.17831527851998946,0.15267175572519084,0
24,89,2136,67,43,0.622762658576312,0.3745317000097067,0.2696629213483146,0
19,78,1482,102,83,0.5518792387365831,0.25713796060297683,0.24358974358974358,0
13,83,1079,66,53,0.6265803296430317,0.3820334888037321,0.1566265060240964,0
15,73,1095,105,90,0.583274838555616,0.1042616693057987,0.2054794520547945,0
19,105,1995,135,116,0.6038948845187568,0.43937572420464893,0.18095238095238095,0
16,101,1616,134,118,0.5614709692740679,0.37019273553085225,0.15841584158415842,0
12,68,816,134,122,0.6503835940914414,0.45732203268052635,0.17647058823529413,0
23,46,1058,113,90,0.6328675418521543,0.0,0.5,0
25,112,2800,136,111,0.4882150722779711,0.14130633141427199,0.22321428571428573,0
19,99,1881,133,114,0.48182205495530434,0.19010663276443912,0.1919191919191919,0
10,70,700,133,123,0.5053160315563356,0.39167449025289797,0.14285714285714285,0
17,97,1649,131,114,0.4994864570564621,0.29631023399170303,0.17525773195876287,0
28,95,2660,136,108,0.5420116597110969,0.0,0.29473684210526313,0
10,61,610,119,109,0.5552132273904481,0.4445198186845647,0.16393442622950818,0
13,71,923,133,120,0.5269802109340519,0.2330494811622691,0.18309859154929578,0
15,96,1440,133,118,0.4744024097611098,0.0,0.15625,0
14,54,756,133,119,0.5150972369671118,0.12898254183443322,0.25925925925925924,0
18,123,2214,131,113,0.4626354816682345,0.20921863771756474,0.14634146341463414,0
22,145,3190,130,108,0.44604931640103856,0.24063885153056166,0.15172413793103448,0
36,66,2376,187,151,0.6900287931143166,0.05181294665121542,0.5454545454545454,0
25,86,2150,176,151,0.7705332834136215,0.10877985159383687,0.29069767441860467,0
17,48,816,131,114,0.44801083229083033,0.16740680035937322,0.3541666666666667,0
20,140,2800,131,111,0.46818045876731074,0.14237369936286676,0.14285714285714285,0
11,75,825,76,65,0.4771348520422593,0.10315456492313306,0.14666666666666667,0
18,85,1530,64,46,0.49474828009474225,0.13309117063077686,0.21176470588235294,0
20,113,2260,65,45,0.5674859992249636,0.2005107388284045,0.17699115044247787,0
16,110,1760,65,49,0.547761832281878,0.30481210792480523,0.14545454545454545,0
45,448,20160,138,93,0.560981169630152,0.27729129726198254,0.10044642857142858,0
28,75,2100,107,79,0.5196214041734953,0.0,0.37333333333333335,0
26,182,4732,130,104,0.48595506975332653,0.26631535293588193,0.14285714285714285,0
25,58,1450,124,99,0.5379979786767333,0.36086613065279644,0.43103448275862066,0
28,89,2492,129,101,0.5227507086818938,0.439452951769288,0.3146067415730337,0
12,58,696,105,93,0.5552842918615606,0.42273699479855115,0.20689655172413793,0
31,64,1984,107,76,0.5652861911328494,0.4115715697470293,0.484375,0
16,49,784,95,79,0.515966084817358,0.33487374004306,0.32653061224489793,0
52,230,11960,82,30,0.493114780040048,0.4785339166229409,0.22608695652173913,0
17,47,799,103,86,0.5358320505332589,0.22706635496943015,0.3617021276595745,0
60,103,6180,108,48,0.48081050807697623,0.2156092201002019,0.5825242718446602,0
14,52,728,63,49,0.7215890472673296,0.7861355926510585,0.2692307692307692,0
20,117,2340,65,45,0.8519909728011128,0.8519490857867666,0.17094017094017094,0
37,906,33522,130,93,0.7414702383594557,0.7637267704045789,0.04083885209713024,0
0,0,0,0,0,0.0,0.0,0.0,0
17,90,1530,65,48,0.6826268034611053,0.605472745967571,0.18888888888888888,0
20,114,2280,63,43,0.7547261790242907,0.7793006841116363,0.17543859649122806,0
40,686,27440,131,91,0.7676789602249996,0.7114324534276495,0.05830903790087463,0
15,63,945,64,49,0.7727095306254981,0.7520162206407632,0.23809523809523808,0
16,105,1680,62,46,0.6357573748179906,0.5297211831214181,0.1523809523809524,0
0,0,0,0,0,0.0,0.0,0.0,0
0,0,0,0,0,0.0,0.0,0.0,0
14,96,1344,62,48,0.7284899967009982,0.75819391504259,0.14583333333333334,0
0,0,0,0,0,0.0,0.0,0.0,0
0,0,0,0,0,0.0,0.0,0.0,0
16,82,1312,128,112,0.8088503799030864,0.8043822482679288,0.1951219512195122,0
27,130,3510,129,102,0.731520351890368,0.5957458800296694,0.2076923076923077,0
0,0,0,0,0,0.0,0.0,0.0,0
0,0,0,0,0,0.0,0.0,0.0,0
14,86,1204,59,45,0.8407024153659277,0.4897459669255541,0.16279069767441862,0
11,65,715,129,118,0.6657333738883731,0.6319472333914584,0.16923076923076924,0
13,65,845,128,115,0.557146713787059,0.3579681365289929,0.2,0
12,57,684,130,118,0.625706335865499,0.5725450246099711,0.21052631578947367,0
13,85,1105,132,119,0.5734133398522012,0.4157137590634451,0.15294117647058825,0
20,101,2020,106,86,0.5195642018752591,0.46965980420184833,0.19801980198019803,0
15,80,1200,136,121,0.5604123088067654,0.4682601023176275,0.1875,0
36,177,6372,139,103,0.5289754966055024,0.03415958514004899,0.2033898305084746,0
13,77,1001,135,122,0.5046959193691698,0.3232495705036363,0.16883116883116883,0
32,356,11392,137,105,0.4813660687062431,0.10173145278828659,0.0898876404494382,0
22,114,2508,134,112,0.4962245518562635,0.0,0.19298245614035087,0
12,72,864,129,117,0.49566493686684043,0.0,0.16666666666666666,0
10,71,710,175,165,0.8646061536488416,0.19896967777738017,0.14084507042253522,0
28,73,2044,134,106,0.427642984682536,0.060285693191208196,0.3835616438356164,0
25,59,1475,132,107,0.4689700116321997,0.06426421290145609,0.423728813559322,0
18,80,1440,70,52,0.46875681087870436,0.06089118876912453,0.225,0
38,127,4826,70,32,0.44361661775352845,0.11834464043493609,0.2992125984251969,0
12,64,768,69,57,0.43599569997634047,0.04530169459191779,0.1875,0
17,55,935,182,165,0.4632792597365049,0.2449690225157664,0.3090909090909091,0
14,97,1358,187,173,0.43970195628354974,0.3076780995359374,0.14432989690721648,0
18,61,1098,187,169,0.4695729378821073,0.28968959748903444,0.29508196721311475,0
24,76,1824,137,113,0.46473383430975934,0.20003008415281945,0.3157894736842105,0
24,157,3768,130,106,0.4332973494236062,0.010746350773703891,0.15286624203821655,0
11,70,770,185,174,0.5025912977202771,0.4831351380714935,0.15714285714285714,0
16,38,608,129,113,0.5171293660932391,0.2049995960374977,0.42105263157894735,0
46,765,35190,135,89,0.4627249568122243,0.06046224237086556,0.06013071895424837,0
50,47,2350,187,137,0.4493332606758295,0.0,1.0638297872340425,0
19,40,760,151,132,0.5104145870601122,0.0,0.475,0
13,79,1027,129,116,0.6812153761178522,0.626134685923017,0.16455696202531644,0
21,103,2163,65,44,0.583695284267227,0.5017653590741675,0.20388349514563106,0
72,1436,103392,153,81,0.4518125361582411,0.17052529364415392,0.05013927576601671,0
68,45,3060,137,69,0.4852675706220827,0.0989389477818224,1.511111111111111,0
16,95,1520,127,111,0.6471931060832705,0.5983502292226207,0.16842105263157894,0
20,48,960,187,167,0.543102487910591,0.12989147937795267,0.4166666666666667,0
22,41,902,186,164,0.5317775385613407,0.21845030207948402,0.5365853658536586,0
18,35,630,108,90,0.5875880895837842,0.0,0.5142857142857142,0
42,339,14238,154,112,0.7000891341978854,0.3957272060408218,0.12389380530973451,0
18,51,918,128,110,0.6330550397395526,0.467133144152604,0.35294117647058826,0
14,50,700,128,114,0.6149276327045089,0.5779088455889865,0.28,0
18,107,1926,153,135,1.1094232933595096,1.0098232425177178,0.16822429906542055,0
33,604,19932,118,85,1.0975400762835819,1.1693429530832884,0.054635761589403975,0
0,0,0,0,0,0.0,0.0,0.0,0
0,0,0,0,0,0.0,0.0,0.0,0
16,71,1136,104,88,0.780265151880836,0.7987476287661535,0.22535211267605634,0
0,0,0,0,0,0.0,0.0,0.0,0
31,267,8277,65,34,0.8279359263781356,0.8488221345050625,0.11610486891385768,0
12,70,840,124,112,0.8342120354002315,0.7873330868922823,0.17142857142857143,0
0,0,0,0,0,0.0,0.0,0.0,0
17,92,1564,65,48,0.9174613786341589,0.9005114404506924,0.18478260869565216,0
32,336,10752,75,43,0.9345885466079638,0.8068274878952568,0.09523809523809523,0
16,112,1792,65,49,0.8563690403198171,0.7373651439624003,0.14285714285714285,0
22,68,1496,106,84,0.8992204306549858,0.6923378291995194,0.3235294117647059,0
31,253,7843,112,81,0.6327495809598959,0.46362938755502286,0.1225296442687747,0
10,66,660,130,120,0.680867765014071,0.5623249354871828,0.15151515151515152,0
21,100,2100,130,109,0.6809227003676491,0.35808293919081985,0.21,0
22,77,1694,120,98,0.614076153409594,0.29316474167364903,0.2857142857142857,0
13,81,1053,100,87,0.735644029916518,0.6582737017594247,0.16049382716049382,0
29,189,5481,153,124,0.6459415824479614,0.3250754492668048,0.15343915343915343,0
17,100,1700,111,94,0.5500127542053285,0.12875741984002093,0.17,0
14,55,770,108,94,0.494078857522972,0.0,0.2545454545454545,0
13,66,858,67,54,0.5213305723414055,0.38939398646186724,0.19696969696969696,0
17,98,1666,110,93,0.49024475559550157,0.0,0.17346938775510204,0
32,83,2656,113,81,0.5798274662707685,0.03399540607409279,0.3855421686746988,0
54,267,14418,79,25,0.5303536909535181,0.4533002638371436,0.20224719101123595,0
37,211,7807,139,102,0.5801256615559444,0.37070046500906395,0.17535545023696683,0
48,698,33504,139,91,0.5871735559590908,0.4856932081094003,0.06876790830945559,0
19,51,969,137,118,0.5606140384637512,0.5411620069772779,0.37254901960784315,0
53,721,38213,137,84,0.5031497876934565,0.10398464147648268,0.07350901525658807,0
16,78,1248,129,113,0.5112215593005054,0.48992302553957223,0.20512820512820512,0
15,71,1065,135,120,0.46647316327869576,0.0,0.2112676056338028,0
31,222,6882,137,106,0.6855050189017277,0.23997338114014125,0.13963963963963963,0
13,63,819,127,114,0.5072439402359074,0.4396753569637083,0.20634920634920634,0
16,62,992,130,114,0.4831898595108509,0.1915406926048586,0.25806451612903225,0
35,101,3535,131,96,0.4525240296198557,0.041930929045689035,0.3465346534653465,0
21,58,1218,130,109,0.4651404133411558,0.009847554531911915,0.3620689655172414,0
21,58,1218,133,112,0.43642779040536184,0.0,0.3620689655172414,0
15,69,1035,133,118,0.46825260788764284,0.0631801231065169,0.21739130434782608,0
21,110,2310,134,113,0.4499451597787252,0.030768057512706188,0.19090909090909092,0
16,38,608,130,114,0.4602658489142157,0.13948557594285407,0.42105263157894735,0
26,115,2990,136,110,0.43803453971395173,0.015842757339021348,0.22608695652173913,0
19,93,1767,131,112,0.4265304170172046,0.1492592751119153,0.20430107526881722,0
17,51,867,134,117,0.45475601388755005,0.0963872383399833,0.3333333333333333,0
12,54,648,128,116,0.4637428709047008,0.14144285282742142,0.2222222222222222,0
18,125,2250,129,111,0.4965136093997927,0.26039473803705615,0.144,0
15,56,840,130,115,0.48530878508577197,0.2855668220281396,0.26785714285714285,0
25,166,4150,71,46,0.4899124916862538,0.18760753940955838,0.15060240963855423,0
27,78,2106,111,84,0.7807524554149952,0.21908229194503837,0.34615384615384615,0
53,589,31217,136,83,0.5789150220171008,0.34911250666426336,0.0899830220713073,0
18,79,1422,134,116,0.5505002736340447,0.44387059880265534,0.22784810126582278,0
18,92,1656,106,88,0.6010817153543933,0.4986147892696537,0.1956521739130435,0
24,40,960,136,112,0.532790290653261,0.3700993872810941,0.6,0
16,90,1440,112,96,0.4903366050263422,0.2470898271629584,0.17777777777777778,0
16,59,944,131,115,0.5248241592063161,0.21399996661391468,0.2711864406779661,0
12,58,696,132,120,0.5722263032274275,0.45659378170767656,0.20689655172413793,0
17,86,1462,87,70,0.8540086213684601,0.3530053943121505,0.19767441860465115,0
16,80,1280,136,120,0.5427908003164695,0.30209644793214036,0.2,0
23,66,1518,104,81,0.6356434669312621,0.09458696888907542,0.3484848484848485,0
24,90,2160,136,112,0.5075911261005494,0.3595719768079315,0.26666666666666666,0
31,453,14043,66,35,0.9917089899491353,1.002227230299354,0.0684326710816777,0
20,124,2480,64,44,0.7792150518130393,0.6236112625859119,0.16129032258064516,0
0,0,0,0,0,0.0,0.0,0.0,0
20,130,2600,65,45,0.9596846361470119,0.8996171661478969,0.15384615384615385,0
0,0,0,0,0,0.0,0.0,0.0,0
0,0,0,0,0,0.0,0.0,0.0,0
0,0,0,0,0,0.0,0.0,0.0,0
12,51,612,65,53,0.8344477607412717,0.8124011345538333,0.23529411764705882,0
14,56,784,66,52,0.9430298228469625,0.42121829379345016,0.25,0
19,60,1140,128,109,0.9892369541419385,0.3482827351921391,0.31666666666666665,0
18,119,2142,128,110,0.8060645553573695,0.8464462649022785,0.15126050420168066,0
20,136,2720,152,132,1.2414549164862188,0.8757173159029094,0.14705882352941177,0
18,67,1206,152,134,0.9991198304728494,0.5254909289423254,0.26865671641791045,0
0,0,0,0,0,0.0,0.0,0.0,0
0,0,0,0,0,0.0,0.0,0.0,0
0,0,0,0,0,0.0,0.0,0.0,0
30,74,2220,129,99,0.6963970653510012,0.5327814495429544,0.40540540540540543,0
14,100,1400,134,120,0.5924251868807086,0.4064745282772578,0.14,0
19,125,2375,132,113,0.6274344770290183,0.3611525149014554,0.152,0
13,92,1196,135,122,0.5419310744926306,0.40670903206401876,0.14130434782608695,0
10,63,630,140,130,0.5603458175601284,0.2878933678338753,0.15873015873015872,0
15,82,1230,134,119,0.5353085487686671,0.33121458181598057,0.18292682926829268,0
17,105,1785,134,117,0.4823464801317143,0.4382948487521042,0.1619047619047619,0
24,78,1872,132,108,0.7646264012792026,0.6795503340509418,0.3076923076923077,0
32,346,11072,76,44,0.5595613824806641,0.46624546698215574,0.09248554913294797,0
39,670,26130,139,100,0.5681846259987096,0.5151931977347524,0.058208955223880594,0
45,627,28215,138,93,0.5301492772545816,0.15022843855996945,0.07177033492822966,0
42,640,26880,137,95,0.5300565192795829,0.12946327378988248,0.065625,0
11,62,682,135,124,0.5110430760356023,0.045537103695095116,0.1774193548387097,0
17,61,1037,129,112,0.4915048407254163,0.3508742523108024,0.2786885245901639,0
24,123,2952,133,109,0.4972584584122468,0.25397953819919816,0.1951219512195122,0
44,267,11748,134,90,0.4491953014822757,0.1117426649618149,0.1647940074906367,0
21,66,1386,64,43,0.509340417532932,0.306625155741867,0.3181818181818182,0
19,117,2223,132,113,0.4480686047123592,0.0,0.1623931623931624,0
28,196,5488,72,44,0.46704611858610645,0.15645925982465306,0.14285714285714285,0
13,67,871,180,167,0.5753820875734985,0.3311531088076191,0.19402985074626866,0
10,70,700,124,114,0.4459313201414588,0.11315097071721658,0.14285714285714285,0
23,164,3772,131,108,0.49524835916123744,0.0,0.1402439024390244,0
14,58,812,130,116,0.4585322564194178,0.10295386152644537,0.2413793103448276,0
20,87,1740,131,111,0.4358859821745339,0.037075667072064264,0.22988505747126436,0
12,57,684,130,118,0.4685472214749962,0.16666140697840462,0.21052631578947367,0
22,98,2156,130,108,0.7123309319709494,0.24346430508290626,0.22448979591836735,0
21,116,2436,132,111,0.46498156840006094,0.25099977544142804,0.1810344827586207,0
21,145,3045,130,109,0.45566908103003473,0.1343048652606304,0.14482758620689656,0
12,60,720,119,107,0.4803003883938545,0.0,0.2,0
23,150,3450,130,107,0.5050642933360553,0.2376886925796733,0.15333333333333332,0
12,51,612,104,92,0.5841631207424033,0.20929343540370018,0.23529411764705882,0
21,67,1407,106,85,0.7654400953780759,0.05313337341224221,0.31343283582089554,0
98,230,22540,135,37,0.5439146353236615,0.31207126696732645,0.4260869565217391,0
23,87,2001,132,109,0.6011023138886163,0.1548737235833536,0.26436781609195403,0
51,459,23409,135,84,0.5297567035312599,0.43460311973925975,0.1111111111111111,0
12,80,960,134,122,0.5011478216376987,0.40507719059977626,0.15,0
20,70,1400,105,85,0.6698972105828106,0.2875995645364392,0.2857142857142857,0
19,51,969,80,61,0.4772919920230636,0.4072095306339897,0.37254901960784315,0
12,53,636,104,92,0.5924146017846745,0.020406169763174786,0.22641509433962265,0
23,106,2438,106,83,0.809817027991177,0.1675176863674761,0.2169811320754717,0
12,76,912,131,119,0.5635236896087036,0.492420587542043,0.15789473684210525,0
23,163,3749,136,113,0.502278591678572,0.3226450463720512,0.1411042944785276,0
0,0,0,0,0,0.0,0.0,0.0,0
31,285,8835,65,34,0.8371172470652054,0.794969134911247,0.10877192982456141,0
0,0,0,0,0,0.0,0.0,0.0,0
14,55,770,121,107,0.9021029291506845,0.4417371172564878,0.2545454545454545,0
26,179,4654,65,39,1.117274923975052,1.1256032071553228,0.1452513966480447,0
37,559,20683,128,91,1.1093603213415506,1.1649418599017594,0.06618962432915922,0
0,0,0,0,0,0.0,0.0,0.0,0
33,763,25179,129,96,1.2427788639252308,1.278490543920778,0.04325032765399738,0
0,0,0,0,0,0.0,0.0,0.0,0
0,0,0,0,0,0.0,0.0,0.0,0
0,0,0,0,0,0.0,0.0,0.0,0
0,0,0,0,0,0.0,0.0,0.0,0
43,562,24166,130,87,0.6825611858556568,0.5526537898064553,0.07651245551601424,0
17,102,1734,129,112,0.8340904081515705,0.7614354824050502,0.16666666666666666,0
52,476,24752,131,79,1.0194949330758927,0.9799853863323491,0.1092436974789916,0
22,92,2024,127,105,0.6600180258638885,0.6041656439307305,0.2391304347826087,0
12,66,792,133,121,0.6787896545693372,0.4873574429166804,0.18181818181818182,0
16,101,1616,135,119,0.6571692453143612,0.45414392980257473,0.15841584158415842,0
18,52,936,136,118,0.6887640124157759,0.589994917662516,0.34615384615384615,0
14,98,1372,134,120,0.6798904487623105,0.7321751647472474,0.14285714285714285,0
17,94,1598,137,120,0.570398673485891,0.3178076924212186,0.18085106382978725,0
15,59,885,131,116,0.5686600645764318,0.18796552873417963,0.2542372881355932,0
18,73,1314,138,120,0.5595344935730602,0.4388759309308824,0.2465753424657534,0
52,298,15496,138,86,0.5433529897143563,0.14485210870228887,0.174496644295302,0
26,152,3952,136,110,0.622122045168036,0.4081061131759873,0.17105263157894737,0
16,70,1120,138,122,0.6260393157672696,0.5514326939415837,0.22857142857142856,0
16,66,1056,136,120,0.5569316470294399,0.32509679803603125,0.24242424242424243,0
15,65,975,61,46,0.5441696797119248,0.4121951061289068,0.23076923076923078,0
16,51,816,130,114,0.5256295985259893,0.31835315069017317,0.3137254901960784,0
17,112,1904,131,114,0.5022804097912481,0.3576460779919533,0.15178571428571427,0
20,135,2700,132,112,0.48631121923390114,0.08589373184895106,0.14814814814814814,0
26,83,2158,132,106,0.4854636740111312,0.12779921076269354,0.3132530120481928,0
21,84,1764,131,110,0.4767213498883646,0.0331284101354089,0.25,0
22,84,1848,132,110,0.49978597566214017,0.24757249527831918,0.2619047619047619,0
36,90,3240,187,151,0.8830438985781424,0.4135036030888532,0.4,0
26,90,2340,176,150,0.9668744813171914,0.19651387275810078,0.28888888888888886,0
16,93,1488,131,115,0.4662385710721184,0.0,0.17204301075268819,0
13,48,624,131,118,0.48583266979348705,0.0,0.2708333333333333,0
12,83,996,127,115,0.4879238540335661,0.09788801455266996,0.14457831325301204,0
15,89,1335,131,116,0.4463256093983643,0.0835675954264664,0.16853932584269662,0
18,108,1944,129,111,0.48031654621708575,0.07755722779790922,0.16666666666666666,0
15,44,660,130,115,0.4669617799028312,0.06277849498341949,0.3409090909090909,0
17,121,2057,131,114,0.4549079377356714,0.0,0.14049586776859505,0
18,70,1260,131,113,0.45894170669897727,0.0,0.2571428571428571,0
14,81,1134,120,106,0.5695682646575804,0.240228946784771,0.1728395061728395,0
0,0,0,0,0,0.0,0.0,0.0,0
15,79,1185,104,89,0.5575558965730989,0.19086225830337838,0.189873417721519,0
26,173,4498,135,109,0.5404216659496381,0.30535632787521044,0.15028901734104047,0
19,128,2432,131,112,0.6344740052937274,0.339241136093662,0.1484375,0
18,52,936,137,119,0.5551849432510383,0.4301318328676666,0.34615384615384615,0
12,64,768,128,116,0.6403307562554075,0.3421524695054905,0.1875,0
19,128,2432,137,118,0.5123773761709305,0.33648217776717004,0.1484375,0
31,299,9269,130,99,0.5696700834892564,0.3993359161544594,0.10367892976588629,0
31,251,7781,140,109,0.5940310833426241,0.4201805851511106,0.12350597609561753,0
15,61,915,124,109,0.624096957028349,0.43434864683663804,0.2459016393442623,0
14,87,1218,60,46,0.6847002225877571,0.6969810173641945,0.16091954022988506,0
0,0,0,0,0,0.0,0.0,0.0,0
0,0,0,0,0,0.0,0.0,0.0,0
54,39,2106,187,133,0.5735620404040411,0.0,1.3846153846153846,0
117,273,31941,187,70,0.37079002459416566,0.0,0.42857142857142855,0
34,36,1224,187,153,0.563377373543218,0.0,0.9444444444444444,0
54,49,2646,187,133,0.48424870712536483,0.0,1.1020408163265305,0
118,831,98058,187,69,0.4533010970607632,0.03790830645415477,0.14199759326113118,0
82,53,4346,152,70,0.5640974755327166,0.16689012163664516,1.5471698113207548,0
19,104,1976,132,113,0.6513646636164243,0.6326400020775741,0.18269230769230768,0
19,65,1235,151,132,0.5665144332718197,0.34783366854530445,0.2923076923076923,0
32,355,11360,67,35,0.795305233947741,0.7782161237095121,0.09014084507042254,0
20,126,2520,73,53,0.4963914854563948,0.3254584205750164,0.15873015873015872,0
23,94,2162,133,110,0.5412684347997071,0.4655159762172844,0.24468085106382978,0
32,746,23872,66,34,0.8336725048283611,0.8652230154323539,0.04289544235924933,0
14,49,686,64,50,0.6509037750656627,0.6073481456190889,0.2857142857142857,0
15,80,1200,130,115,0.6637775037929385,0.5687722480837715,0.1875,0
20,93,1860,131,111,0.7067958894278034,0.6515308533767327,0.21505376344086022,0
33,1004,33132,131,98,0.6192148643274976,0.5378131006442496,0.03286852589641434,0
21,126,2646,66,45,0.6900569551062913,0.5687079388507812,0.16666666666666666,0
23,80,1840,106,83,0.9255858307653871,0.3405680803264884,0.2875,0
11,67,737,65,54,0.6603787043079881,0.4988459947873662,0.16417910447761194,0
11,72,792,66,55,0.561149207227616,0.4134571877997127,0.1527777777777778,0
20,88,1760,66,46,0.5896553683286956,0.2786150735433652,0.22727272727272727,0
18,39,702,130,112,0.537053010475217,0.3379378594508229,0.46153846153846156,0
21,55,1155,126,105,0.6092729432694249,0.41986141075989925,0.38181818181818183,0
23,153,3519,67,44,0.6218284356345589,0.39650888616416463,0.1503267973856209,0
16,108,1728,129,113,0.5891122243114599,0.5341047211626255,0.14814814814814814,0
38,795,30210,135,97,0.6032633094474473,0.5796161699228981,0.04779874213836478,0
29,58,1682,134,105,0.5674882468561316,0.2656696951566242,0.5,0
24,132,3168,133,109,0.49553143292632823,0.24028802787600304,0.18181818181818182,0
13,79,1027,131,118,0.5664233693678609,0.5721475368124701,0.16455696202531644,0
19,56,1064,133,114,0.4958259869939774,0.16412070484666974,0.3392857142857143,0
18,109,1962,95,77,0.4962029490022647,0.3184784685361888,0.1651376146788991,0
14,97,1358,130,116,0.5425314536677862,0.40300304413403576,0.14432989690721648,0
21,86,1806,129,108,0.4821313526689961,0.054337572711578366,0.2441860465116279,0
12,60,720,133,121,0.48554570558626586,0.23844061102072237,0.2,0
10,68,680,130,120,0.47497646428307955,0.25708154461397537,0.14705882352941177,0
14,59,826,127,113,0.5061110349422554,0.15017844442194783,0.23728813559322035,0
16,91,1456,129,113,0.4648800532276457,0.13958620221652662,0.17582417582417584,0
22,64,1408,133,111,0.47041018902536935,0.08596621638791387,0.34375,0
13,49,637,119,106,0.45226148827159707,0.08185495656030863,0.2653061224489796,0
20,96,1920,132,112,0.4741232112614404,0.328828398381657,0.20833333333333334,0
20,87,1740,134,114,0.42576938384588775,0.0,0.22988505747126436,0
19,60,1140,187,168,0.4514187550166945,0.3521645943792447,0.31666666666666665,0
13,62,806,182,169,0.47045213533184255,0.3419604277216768,0.20967741935483872,0
13,53,689,187,174,0.474186506994374,0.4056908817558331,0.24528301886792453,0
11,61,671,175,164,0.5151554889953295,0.34004496464047185,0.18032786885245902,0
15,51,765,19,4,0.500997953109711,0.37459723910167436,0.29411764705882354,0
12,71,852,130,118,0.5070926897329394,0.19587501228559379,0.16901408450704225,0
24,167,4008,129,105,0.5190507744033545,0.2524587014272307,0.1437125748502994,0
55,620,34100,137,82,0.4981703196080928,0.09303959097467064,0.08870967741935484,0
26,139,3614,131,105,0.47502979793167016,0.22947155392384402,0.18705035971223022,0
20,102,2040,126,106,0.4533881805244382,0.10110947021162493,0.19607843137254902,0
16,52,832,139,123,0.4569324903205481,0.4348245481963496,0.3076923076923077,0
16,99,1584,135,119,0.5443290296913651,0.32582426751073945,0.16161616161616163,0
17,46,782,136,119,0.5517514664516358,0.4038226304328001,0.3695652173913043,0
30,45,1350,104,74,0.5047062943595836,0.24626773971301547,0.6666666666666666,0
17,63,1071,103,86,0.5837232695200227,0.5050136897886792,0.2698412698412698,0
57,732,41724,132,75,0.4631101001226425,0.2695740205734541,0.0778688524590164,0
16,39,624,113,97,0.47794135221671813,0.11186859047520184,0.41025641025641024,0
0,0,0,0,0,0.0,0.0,0.0,0
0,0,0,0,0,0.0,0.0,0.0,0
0,0,0,0,0,0.0,0.0,0.0,0
17,113,1921,64,47,0.8939241267082955,0.965925123395941,0.1504424778761062,0
23,156,3588,105,82,1.2508271984290067,1.2012694031766635,0.14743589743589744,0
13,57,741,100,87,1.0281952113453976,0.9618046537573197,0.22807017543859648,0
0,0,0,0,0,0.0,0.0,0.0,0
32,892,28544,65,33,1.1007549683356284,1.1388975962162398,0.03587443946188341,0
44,623,27412,128,84,1.29490446928207,1.3701710542562318,0.07062600321027288,0
0,0,0,0,0,0.0,0.0,0.0,0
15,52,780,127,112,0.8565948425370408,0.8339640508481727,0.28846153846153844,0
20,114,2280,65,45,0.9204373986142986,0.8554275281569751,0.17543859649122806,0
0,0,0,0,0,0.0,0.0,0.0,0
31,357,11067,132,101,0.7033844311310492,0.5045448592788413,0.08683473389355742,0
18,49,882,69,51,0.7691375932209983,0.4916247868080361,0.3673469387755102,0
0,0,0,0,0,0.0,0.0,0.0,0
13,75,975,132,119,0.54974228774055,0.5614067983509803,0.17333333333333334,0
16,82,1312,139,123,0.6308526885385339,0.42824744974916773,0.1951219512195122,0
14,59,826,112,98,0.5491212467570583,0.41302821116505356,0.23728813559322035,0
26,104,2704,136,110,0.5233241281092517,0.35671445151188313,0.25,0
0,0,0,0,0,0.0,0.0,0.0,0
44,538,23672,136,92,0.5225399020967043,0.3798785961605366,0.08178438661710037,0
0,0,0,0,0,0.0,0.0,0.0,0
22,135,2970,105,83,0.5328575807824406,0.48189216660122747,0.16296296296296298,0
10,63,630,129,119,0.5257298990194328,0.2137521932241698,0.15873015873015872,0
25,81,2025,108,83,0.6139148819269965,0.603840394812396,0.30864197530864196,0
15,58,870,137,122,0.5473198475837716,0.4151830864711001,0.25862068965517243,0
19,65,1235,106,87,0.5664746390353204,0.0,0.2923076923076923,0
18,125,2250,138,120,0.5853621090784946,0.3097693656072024,0.144,0
12,54,648,133,121,0.5033728263466668,0.335029282190919,0.2222222222222222,0
13,48,624,134,121,0.5287398017185443,0.19665616249512974,0.2708333333333333,0
26,182,4732,140,114,0.4626462293740372,0.0,0.14285714285714285,0
27,148,3996,142,115,0.5300450286523827,0.18010608247781004,0.18243243243243243,0
34,549,18666,141,107,0.5199783232983537,0.16500704224076349,0.061930783242258654,0
13,60,780,126,113,0.558684216921098,0.3918232436166002,0.21666666666666667,0
23,85,1955,133,110,0.4879171623628306,0.0,0.27058823529411763,0
14,80,1120,129,115,0.5392442842561932,0.39857870261920175,0.175,0
15,93,1395,130,115,0.5318452699284246,0.3670124922509302,0.16129032258064516,0
18,75,1350,129,111,0.4984936925558901,0.18468486410718113,0.24,0
21,101,2121,131,110,0.5004312102883572,0.18701739098496614,0.2079207920792079,0
21,99,2079,131,110,0.5062648710954825,0.31614186956924034,0.21212121212121213,0
20,135,2700,130,110,0.5289635068933932,0.16229565428245604,0.14814814814814814,0
19,52,988,129,110,0.525372649434223,0.3540471356250482,0.36538461538461536,0
42,100,4200,120,78,0.4931530580653663,0.31453381982319245,0.42,0
15,44,660,127,112,0.5046103543141881,0.39749674050143274,0.3409090909090909,0
24,133,3192,131,107,0.4965911129302291,0.22994893943591482,0.18045112781954886,0
17,40,680,71,54,0.48520536989524343,0.10140220842116293,0.425,0
17,85,1445,132,115,0.5716733804807828,0.4213703040377992,0.2,0
17,56,952,135,118,0.5550106997636359,0.3304778791158869,0.30357142857142855,0
12,77,924,131,119,0.5167992686634952,0.30036681604357185,0.15584415584415584,0
24,144,3456,112,88,0.5394627357866696,0.30439477540977306,0.16666666666666666,0
18,71,1278,105,87,0.4907955006665405,0.48793446919672223,0.2535211267605634,0
15,104,1560,130,115,0.5198226411540818,0.3115258446754717,0.14423076923076922,0
15,63,945,130,115,0.5223045187387113,0.3443780389910045,0.23809523809523808,0
15,57,855,104,89,0.55854361324697,0.3663723176443905,0.2631578947368421,0
31,277,8587,129,98,0.5192102911349284,0.3347056162777923,0.11191335740072202,0
11,76,836,131,120,0.6014910321379874,0.35312948801578437,0.14473684210526316,0
13,55,715,153,140,0.7021641687783016,0.41515481850013486,0.23636363636363636,0
19,58,1102,63,44,0.939763367630633,0.9625707536570322,0.3275862068965517,0
0,0,0,0,0,0.0,0.0,0.0,0
40,455,18200,129,89,0.6659911242994675,0.6869364131624334,0.08791208791208792,0
21,79,1659,64,43,0.9318119529795915,0.9120578707031513,0.26582278481012656,0
0,0,0,0,0,0.0,0.0,0.0,0
13,51,663,60,47,0.6929606671417834,0.6084549874491229,0.2549019607843137,0
0,0,0,0,0,0.0,0.0,0.0,0
0,0,0,0,0,0.0,0.0,0.0,0
40,531,21240,130,90,1.0746583227941229,1.018322386614832,0.07532956685499058,0
73,67,4891,120,47,1.1249392133935734,0.2603656608433066,1.0895522388059702,0
17,91,1547,129,112,0.6698569174297486,0.5393844402594046,0.18681318681318682,0
0,0,0,0,0,0.0,0.0,0.0,0
0,0,0,0,0,0.0,0.0,0.0,0
0,0,0,0,0,0.0,0.0,0.0,0
18,95,1710,64,46,0.8843448134316966,0.8857096677232438,0.18947368421052632,0
26,42,1092,96,70,0.5748724894561107,0.25962328106808497,0.6190476190476191,0
20,57,1140,105,85,0.6822227841841877,0.33589828479960215,0.3508771929824561,0
34,444,15096,66,32,0.8127302542350356,0.7432512016682475,0.07657657657657657,0
38,598,22724,68,30,0.9165421762057883,0.8687429611263985,0.06354515050167224,0
22,117,2574,66,44,0.8257495249209692,0.7227078248011981,0.18803418803418803,0
22,135,2970,65,43,0.8173751136603375,0.7876598690411538,0.16296296296296298,0
27,117,3159,132,105,0.8380544063893616,0.6653445125866335,0.23076923076923078,0
10,62,620,64,54,0.6572138804116249,0.6549341566379501,0.16129032258064516,0
0,0,0,0,0,0.0,0.0,0.0,0
0,0,0,0,0,0.0,0.0,0.0,0
0,0,0,0,0,0.0,0.0,0.0,0
0,0,0,0,0,0.0,0.0,0.0,0
0,0,0,0,0,0.0,0.0,0.0,0
0,0,0,0,0,0.0,0.0,0.0,0
12,82,984,59,47,0.531830804703757,0.34404503236672845,0.14634146341463414,0
15,81,1215,129,114,0.54568024507735,0.27370785636768113,0.18518518518518517,0
10,69,690,129,119,0.5613619598345706,0.20402028510567338,0.14492753623188406,0
18,87,1566,128,110,0.5481302131401966,0.4557880251504676,0.20689655172413793,0
0,0,0,0,0,0.0,0.0,0.0,0
11,60,660,129,118,0.5285310673547864,0.2137423214964974,0.18333333333333332,0
0,0,0,0,0,0.0,0.0,0.0,0
32,349,11168,130,98,0.5896438349149278,0.32395902440397284,0.09169054441260745,0
20,135,2700,135,115,0.5065868510784602,0.1443752190006519,0.14814814814814814,0
16,84,1344,128,112,0.5502806525180727,0.10641135269463073,0.19047619047619047,0
37,93,3441,187,150,0.9029062996214592,0.33484612018575344,0.3978494623655914,0
18,78,1404,128,110,0.4932424124081355,0.05674401682592208,0.23076923076923078,0
12,55,660,124,112,0.48572652131123184,0.006983940994525228,0.21818181818181817,0
12,70,840,132,120,0.5507940741948444,0.10646436860004573,0.17142857142857143,0
18,92,1656,134,116,0.456158524006072,0.0,0.1956521739130435,0
13,58,754,127,114,0.4899809464956543,0.07097069603218091,0.22413793103448276,0
19,70,1330,64,45,0.4888745840500141,0.14000761365853417,0.2714285714285714,0
18,114,2052,129,111,0.559461287432787,0.2570266360129917,0.15789473684210525,0
21,102,2142,131,110,0.4965122382289922,0.3668175970066568,0.20588235294117646,0
13,76,988,124,111,0.5276985981439858,0.27809111781002044,0.17105263157894737,0
13,76,988,124,111,0.5276985981439858,0.27809111781002044,0.17105263157894737,0
12,52,624,124,112,0.5030029293438587,0.31527543573600125,0.23076923076923078,0
34,667,22678,70,36,0.5014184074363562,0.09838673966386939,0.050974512743628186,0
26,64,1664,107,81,0.535755465437897,0.0,0.40625,0
12,55,660,108,96,0.49103994275615365,0.0,0.21818181818181817,0
25,43,1075,145,120,0.5058823280284197,0.23660393093706134,0.5813953488372093,0
23,80,1840,114,91,0.4900620885021137,0.13479292571804444,0.2875,0
25,56,1400,107,82,0.5333983303980996,0.2677834169621094,0.44642857142857145,0
21,44,924,155,134,0.5408519627696964,0.15126646259974022,0.4772727272727273,0
37,532,19684,136,99,0.601676964194405,0.33047242136887983,0.06954887218045112,0
32,937,29984,132,100,0.7161813949013593,0.7219948193083953,0.03415154749199573,0
21,86,1806,105,84,0.9045626640390646,0.7392321830395702,0.2441860465116279,0
0,0,0,0,0,0.0,0.0,0.0,0
11,61,671,120,109,0.7593057978855848,0.8612771101592113,0.18032786885245902,0
46,1344,61824,131,85,0.6217079792262843,0.45456900378284015,0.03422619047619048,0
20,61,1220,105,85,1.055986805349836,0.7937469521713505,0.32786885245901637,0
0,0,0,0,0,0.0,0.0,0.0,0
0,0,0,0,0,0.0,0.0,0.0,0
0,0,0,0,0,0.0,0.0,0.0,0
0,0,0,0,0,0.0,0.0,0.0,0
39,852,33228,130,91,0.878162888460507,0.7758644224125709,0.045774647887323945,0
16,104,1664,61,45,0.924883276493912,0.9083939506602162,0.15384615384615385,0
45,991,44595,130,85,1.0084271582131314,1.0688511818101647,0.045408678102926335,0
0,0,0,0,0,0.0,0.0,0.0,0
0,0,0,0,0,0.0,0.0,0.0,0
0,0,0,0,0,0.0,0.0,0.0,0
0,0,0,0,0,0.0,0.0,0.0,0
21,52,1092,130,109,0.695465982499065,0.5575860790579947,0.40384615384615385,0
0,0,0,0,0,0.0,0.0,0.0,0
49,857,41993,131,82,0.568545324970429,0.4406400531636655,0.057176196032672114,0
32,27,864,135,103,0.6211939639634978,0.5685374139902973,1.1851851851851851,0
25,143,3575,72,47,0.5566187155926985,0.419186566189487,0.17482517482517482,0
31,177,5487,109,78,0.5764810654615532,0.5321710180381638,0.1751412429378531,0
18,116,2088,138,120,0.4980305249323574,0.3659709237214872,0.15517241379310345,0
16,38,608,136,120,0.5277741023754311,0.511428578032901,0.42105263157894735,0
19,51,969,111,92,0.499941862030243,0.05409172690792128,0.37254901960784315,0
30,139,4170,134,104,0.4967815411534251,0.19621545959891146,0.2158273381294964,0
24,66,1584,187,163,0.569600393064221,0.4352956232366063,0.36363636363636365,0
149,139,20711,187,38,0.794215163969906,0.3120235525114602,1.0719424460431655,1
16,92,1472,131,115,0.5220102472232433,0.22787853738691244,0.17391304347826086,0
13,86,1118,125,112,0.51892502780155,0.05533048960083205,0.1511627906976744,0
10,61,610,129,119,0.5478525441403952,0.44759376203110185,0.16393442622950818,0
37,286,10582,81,44,0.5698442219944725,0.321834057617643,0.12937062937062938,0
14,50,700,39,25,0.516156841851005,0.45450029164643607,0.28,0
16,68,1088,66,50,0.5188292274666383,0.20286354257699651,0.23529411764705882,0
22,138,3036,129,107,0.4857991763009378,0.11206993030445309,0.15942028985507245,0
13,80,1040,131,118,0.4883455266093338,0.18523885031472528,0.1625,0
21,102,2142,132,111,0.48628241383715015,0.09106902607660393,0.20588235294117646,0
26,136,3536,68,42,0.48994957397576233,0.14265558636552664,0.19117647058823528,0
17,45,765,105,88,0.4905981497138882,0.08990692697167323,0.37777777777777777,0
14,46,644,101,87,0.49937113129936317,0.1721597015733711,0.30434782608695654,0
11,57,627,187,176,0.5400018249510868,0.5152174855365126,0.19298245614035087,0
34,673,22882,138,104,0.5600994330116712,0.2947143006241675,0.05052005943536404,0
114,544,62016,143,29,0.6343441289561023,0.3639886904600492,0.20955882352941177,0
17,47,799,155,138,0.5172530652945205,0.03154059136151701,0.3617021276595745,0
38,1086,41268,141,103,0.569002499198886,0.29043719156800735,0.034990791896869246,0
17,101,1717,187,170,0.45597463497532476,0.0,0.16831683168316833,0
56,49,2744,187,131,0.35363230436028015,0.0,1.1428571428571428,0
16,44,704,179,163,0.4555356882839487,0.0,0.36363636363636365,0
28,79,2212,64,36,0.6679529189775192,0.5746402467966608,0.35443037974683544,0
13,74,962,70,57,0.5754515465318261,0.54832206019172,0.17567567567567569,0
0,0,0,0,0,0.0,0.0,0.0,0
0,0,0,0,0,0.0,0.0,0.0,0
0,0,0,0,0,0.0,0.0,0.0,0
42,222,9324,121,79,0.5733577883588703,0.2321469697602373,0.1891891891891892,0
11,60,660,122,111,0.8697084128107956,0.8580387308356882,0.18333333333333332,0
24,66,1584,106,82,0.93663116490209,0.4176293130079083,0.36363636363636365,0
21,80,1680,105,84,1.1220727972955942,1.0934199580545017,0.2625,0
47,561,26367,134,87,0.8920249305327034,0.8917930500567439,0.08377896613190731,0
0,0,0,0,0,0.0,0.0,0.0,0
0,0,0,0,0,0.0,0.0,0.0,0
34,436,14824,120,86,1.0616200555425415,1.0116467664055055,0.0779816513761468,0
0,0,0,0,0,0.0,0.0,0.0,0
0,0,0,0,0,0.0,0.0,0.0,0
10,66,660,92,82,0.8279789944924529,0.7263553472117636,0.15151515151515152,0
0,0,0,0,0,0.0,0.0,0.0,0
0,0,0,0,0,0.0,0.0,0.0,0
0,0,0,0,0,0.0,0.0,0.0,0
14,49,686,60,46,0.7741714920451206,0.7915309313545926,0.2857142857142857,0
0,0,0,0,0,0.0,0.0,0.0,0
0,0,0,0,0,0.0,0.0,0.0,0
0,0,0,0,0,0.0,0.0,0.0,0
17,89,1513,64,47,0.9054974185476256,0.9034571455961641,0.19101123595505617,0
56,61,3416,187,131,0.9074610286345357,0.5011968078640787,0.9180327868852459,1
11,70,770,57,46,0.8183062755437049,0.7747402439168736,0.15714285714285714,0
42,797,33474,130,88,1.206195923620965,1.3166336378925176,0.05269761606022585,0
11,71,781,121,110,0.7110119223458109,0.5376917004249818,0.15492957746478872,0
0,0,0,0,0,0.0,0.0,0.0,0
21,82,1722,66,45,0.6223485312319131,0.4113035235193353,0.25609756097560976,0
21,109,2289,187,166,0.6597516729340118,0.5677193513336694,0.1926605504587156,0
18,88,1584,97,79,0.6356927147778965,0.5309077122811574,0.20454545454545456,0
15,44,660,100,85,0.6286884571666205,0.6093170413959957,0.3409090909090909,0
24,132,3168,66,42,0.5927621057666135,0.3315494700667122,0.18181818181818182,0
14,51,714,131,117,0.5315472558695762,0.494508131385512,0.27450980392156865,0
24,158,3792,135,111,0.5295296670297011,0.42471933839711606,0.1518987341772152,0
21,109,2289,130,109,0.6259147515904933,0.3781107063031003,0.1926605504587156,0
22,81,1782,187,165,0.8665053216611858,0.4128358748636959,0.2716049382716049,0
21,84,1764,187,166,0.7869581932135002,0.31551290211844457,0.25,0
21,79,1659,187,166,0.6342534737799167,0.31512675834680914,0.26582278481012656,0
42,74,3108,66,24,0.560936131261459,0.40468887526380676,0.5675675675675675,0
41,544,22304,70,29,0.532240708365559,0.42603710595673455,0.07536764705882353,0
10,61,610,113,103,0.5104492708683244,0.37110538315648006,0.16393442622950818,0
32,875,28000,68,36,0.5203727200118401,0.29083990747023053,0.036571428571428574,0
13,92,1196,64,51,0.5128501278172981,0.2627413346085843,0.14130434782608695,0
10,67,670,68,58,0.5048572634881486,0.2781081608213598,0.14925373134328357,0
36,382,13752,74,38,0.5222151203598063,0.32297701577074917,0.09424083769633508,0
26,157,4082,66,40,0.5148682732853097,0.23393539947617237,0.16560509554140126,0
21,38,798,185,164,0.47863130418993405,0.3594777995414123,0.5526315789473685,0
18,96,1728,64,46,0.5386580997925189,0.26484887678869773,0.1875,0
18,114,2052,65,47,0.4977617062030848,0.29116473712704605,0.15789473684210525,0
20,72,1440,66,46,0.5830621981313089,0.3134439251813091,0.2777777777777778,0
16,75,1200,63,47,0.5191752079498837,0.05860916960437937,0.21333333333333335,0
19,100,1900,105,86,0.546668501425278,0.45519974667724894,0.19,0
23,70,1610,134,111,0.5149570012089283,0.29799711643371185,0.32857142857142857,0
41,371,15211,69,28,0.5609652635475323,0.35974686459796645,0.1105121293800539,0
35,788,27580,76,41,0.5619277103305247,0.29096963621624444,0.044416243654822336,0
13,59,767,122,109,0.5222431910762876,0.44609723227928316,0.22033898305084745,0
39,578,22542,136,97,0.5393928010337925,0.3107677664035786,0.06747404844290658,0
18,57,1026,63,45,0.5017912556787159,0.21281281755861606,0.3157894736842105,0
18,63,1134,133,115,0.5001219421023689,0.25898488514140483,0.2857142857142857,0
77,1056,81312,134,57,0.5471314086830842,0.450946692769659,0.07291666666666667,1
11,58,638,138,127,0.6823212923084395,0.5124279041231656,0.1896551724137931,1
38,513,19494,137,99,0.5978463804471624,0.4841159335785588,0.07407407407407407,0
13,66,858,133,120,0.5522995818490289,0.44701486645578103,0.19696969696969696,0
17,58,986,96,79,0.5979249667454052,0.45277674606472607,0.29310344827586204,0
29,94,2726,112,83,0.8300181159742468,0.42737989108264124,0.30851063829787234,0
12,53,636,128,116,0.6703287236754485,0.630978405380077,0.22641509433962265,0
37,949,35113,120,83,0.7100486867341891,0.5745868674211243,0.03898840885142255,0
13,63,819,92,79,0.6463530816444315,0.3783175871565604,0.20634920634920634,0
0,0,0,0,0,0.0,0.0,0.0,0
25,135,3375,66,41,0.5581845236934585,0.48851372992106634,0.18518518518518517,0
28,182,5096,63,35,0.6554423523682347,0.5423124516895443,0.15384615384615385,0
28,156,4368,64,36,0.6222365501744763,0.5365020016620041,0.1794871794871795,0
0,0,0,0,0,0.0,0.0,0.0,0
0,0,0,0,0,0.0,0.0,0.0,0
14,49,686,64,50,0.7087214017632241,0.5146659913219164,0.2857142857142857,0
0,0,0,0,0,0.0,0.0,0.0,0
42,450,18900,154,112,0.8532377821857133,0.5342391682209586,0.09333333333333334,0
21,141,2961,129,108,0.9745689263533043,0.7313542601799627,0.14893617021276595,0
10,65,650,100,90,0.8806911841388996,0.29978396936587814,0.15384615384615385,0
19,89,1691,151,132,0.8599936876445975,0.6679613847130939,0.21348314606741572,0
22,130,2860,154,132,0.7869666463593804,0.2532722972160346,0.16923076923076924,0
45,172,7740,154,109,0.7369559165554569,0.5912932051872771,0.2616279069767442,0
12,84,1008,63,51,0.7013379934540015,0.5421035906911068,0.14285714285714285,0
12,85,1020,113,101,0.6625903946369537,0.44616516887324964,0.1411764705882353,0
13,62,806,130,117,0.839609667801066,0.7370532801481047,0.20967741935483872,0
17,82,1394,148,131,0.7313161770664776,0.5263145556569161,0.2073170731707317,0
45,205,9225,153,108,0.6454454545592656,0.2967876371320122,0.21951219512195122,0
14,55,770,134,120,0.5820150060979615,0.36712857520010667,0.2545454545454545,0
23,98,2254,138,115,0.4886549315652213,0.2695740373846771,0.23469387755102042,0
15,83,1245,132,117,0.5335123326030352,0.27509882829588184,0.18072289156626506,0
15,50,750,183,168,0.6144300371592731,0.3645200662231034,0.3,0
34,291,9894,66,32,0.5725065334031146,0.26415288633832623,0.11683848797250859,0
13,53,689,179,166,0.6498772312741464,0.38554734089438436,0.24528301886792453,0
20,92,1840,131,111,0.5001124561186139,0.1112307426497943,0.21739130434782608,0
17,86,1462,128,111,0.5399689732732481,0.11026575416582564,0.19767441860465115,0
13,70,910,127,114,0.5340219900859225,0.1686661143243174,0.18571428571428572,0
13,47,611,181,168,0.5949512387791723,0.3887369458783595,0.2765957446808511,0
30,129,3870,67,37,0.500889513610439,0.2550076929950979,0.23255813953488372,0
15,97,1455,128,113,0.5437564556146833,0.3327036391957634,0.15463917525773196,0
20,95,1900,131,111,0.5280074820481344,0.3896409575235509,0.21052631578947367,0
10,68,680,129,119,0.5499622709896695,0.2783713816719186,0.14705882352941177,0
14,72,1008,137,123,0.5299016864075901,0.1504808686865175,0.19444444444444445,0
16,103,1648,130,114,0.5070404320997235,0.3333406586483784,0.1553398058252427,0
20,93,1860,130,110,0.4823128868198685,0.1393579848297035,0.21505376344086022,0
18,91,1638,132,114,0.5005886897785389,0.27548188604358137,0.1978021978021978,0
20,93,1860,132,112,0.5610862440004336,0.4126397018278047,0.21505376344086022,0
23,74,1702,136,113,0.4832889488112324,0.2390667458149276,0.3108108108108108,0
17,71,1207,130,113,0.5302002064594138,0.3174525673431356,0.23943661971830985,0
12,57,684,135,123,0.5018928986985823,0.24027740769605588,0.21052631578947367,0
41,150,6150,137,96,0.47402479589508084,0.0,0.2733333333333333,0
31,461,14291,136,105,0.5073213330396447,0.324078625211674,0.06724511930585683,0
23,131,3013,134,111,0.525215166914603,0.38006188579574135,0.17557251908396945,0
19,78,1482,131,112,0.49916198053879135,0.26070829141709073,0.24358974358974358,0
23,78,1794,89,66,0.4873298686502769,0.0,0.2948717948717949,0
15,68,1020,129,114,0.5087608936852114,0.492301640139222,0.22058823529411764,0
11,66,726,120,109,0.5880046210287592,0.24484653611589852,0.16666666666666666,0
18,44,792,97,79,0.5033751351711895,0.4598798064771473,0.4090909090909091,0
13,78,1014,89,76,0.5631748512818702,0.46940077172702294,0.16666666666666666,0
15,43,645,88,73,0.5378619770887453,0.6767821040206238,0.3488372093023256,0
16,113,1808,93,77,0.5426582624204248,0.3980134753886139,0.1415929203539823,0
13,68,884,131,118,0.5437842979446383,0.3943912179401686,0.19117647058823528,0
18,74,1332,65,47,0.56537756712578,0.39039165819426325,0.24324324324324326,0
13,59,767,131,118,0.5617493295518713,0.5532080351694497,0.22033898305084745,0
0,0,0,0,0,0.0,0.0,0.0,0
15,84,1260,66,51,1.1414592870040547,1.2398861530223848,0.17857142857142858,0
20,74,1480,63,43,0.7929729189081768,0.7146423603312999,0.2702702702702703,0
16,82,1312,106,90,0.7162839327233428,0.6270545531557655,0.1951219512195122,0
19,127,2413,63,44,0.7431535431243864,0.5626344208613315,0.14960629921259844,0
0,0,0,0,0,0.0,0.0,0.0,0
14,46,644,129,115,0.6090453615955984,0.5573006682710789,0.30434782608695654,0
15,45,675,101,86,0.5933659046486409,0.6716561676651097,0.3333333333333333,0
40,739,29560,132,92,0.5898610632432466,0.34989043678536075,0.05412719891745602,0
16,84,1344,135,119,0.5066322222795153,0.329140394235662,0.19047619047619047,0
11,76,836,129,118,0.4969382664621902,0.38827117926681654,0.14473684210526316,0
17,41,697,131,114,0.4908402799173845,0.2525626383936778,0.4146341463414634,0
12,58,696,122,110,0.5667354428660446,0.05890203927026637,0.20689655172413793,0
13,56,728,134,121,0.5194483627111797,0.27180353326885287,0.23214285714285715,0
16,53,848,124,108,0.4790875053632649,0.1222463383592897,0.3018867924528302,0
23,84,1932,131,108,0.4390801582551661,0.08545539268455707,0.27380952380952384,0
14,91,1274,133,119,0.5695982216320602,0.40897244091937335,0.15384615384615385,0
13,69,897,129,116,0.5336930440537302,0.19536451171365934,0.18840579710144928,0
23,78,1794,67,44,0.5885876250041978,0.3149908113100909,0.2948717948717949,0
13,59,767,132,119,0.5612495226594729,0.29284221514081227,0.22033898305084745,0
13,53,689,123,110,0.5264530338799424,0.301767187427361,0.24528301886792453,0
12,62,744,135,123,0.5805057052223718,0.34720136563872284,0.1935483870967742,0
18,98,1764,132,114,0.577055734072502,0.4335008725270872,0.1836734693877551,0
14,100,1400,133,119,0.5817427942780686,0.4527274125803832,0.14,0
29,127,3683,64,35,0.523870553139283,0.45351826708242376,0.2283464566929134,0
14,87,1218,136,122,0.598862274405442,0.4371786901219646,0.16091954022988506,0
29,146,4234,108,79,0.5257530165788761,0.0,0.19863013698630136,0
33,324,10692,136,103,0.48843835603939595,0.25477363381441803,0.10185185185185185,0
19,126,2394,136,117,0.5780377292200735,0.35830874321791695,0.15079365079365079,0
20,107,2140,130,110,0.5201314295419507,0.32177737473559376,0.18691588785046728,0
11,75,825,132,121,0.5754338138946036,0.3390977959788622,0.14666666666666667,0
32,186,5952,136,104,0.5166074570187223,0.2517452916532721,0.17204301075268819,0
25,122,3050,132,107,0.8824805184000309,0.29496672765664206,0.20491803278688525,0
15,65,975,132,117,0.47492254598335304,0.2871954983289236,0.23076923076923078,0
16,101,1616,137,121,0.4969431878048029,0.22939839757425212,0.15841584158415842,0
13,61,793,134,121,0.5139183074243336,0.21379615390344542,0.21311475409836064,0
42,88,3696,134,92,0.5288294616448134,0.12263538409913691,0.4772727272727273,0
15,46,690,138,123,0.5457488041527563,0.4528218684726767,0.32608695652173914,0
13,67,871,130,117,0.6072320749569861,0.4785683288481955,0.19402985074626866,0
26,112,2912,137,111,0.49923819887527426,0.22688606963779395,0.23214285714285715,0
12,52,624,130,118,0.5433226835801904,0.3747078370851939,0.23076923076923078,0
17,81,1377,135,118,0.5547185904889487,0.33670639591469576,0.20987654320987653,0
16,57,912,137,121,0.5755815775507388,0.44187856649337065,0.2807017543859649,0
25,57,1425,187,162,0.5965180699148944,0.38108014293642145,0.43859649122807015,0
19,103,1957,132,113,0.5241210134074685,0.2932126423005476,0.18446601941747573,0
17,72,1224,137,120,0.5581212359540533,0.3713232184597882,0.2361111111111111,0
12,72,864,110,98,0.5126205298688646,0.45019274839740475,0.16666666666666666,0
33,186,6138,137,104,0.48590314244732924,0.29593185880906314,0.1774193548387097,0
16,100,1600,137,121,0.525248713266434,0.3904480215734187,0.16,0
14,44,616,113,99,0.5277627920207063,0.39723309022286835,0.3181818181818182,0
11,72,792,132,121,0.5748995484954571,0.37516571296412793,0.1527777777777778,0
23,101,2323,135,112,0.5681858281574733,0.5140169092663858,0.22772277227722773,0
12,51,612,124,112,0.5603556894547309,0.2757423416510837,0.23529411764705882,0
47,116,5452,134,87,0.42688382046192264,0.11207489410080364,0.4051724137931034,0
25,138,3450,73,48,0.4701988627866614,0.29686829693302763,0.18115942028985507,0
15,94,1410,130,115,0.5516600847678897,0.3043248687869072,0.1595744680851064,0
16,74,1184,105,89,0.5971840507434963,0.06030309797225342,0.21621621621621623,0
12,58,696,123,111,0.5343713959303574,0.3176153863288125,0.20689655172413793,0
49,930,45570,133,84,0.7909116396649349,0.7163076307464538,0.05268817204301075,0
0,0,0,0,0,0.0,0.0,0.0,0
16,105,1680,101,85,0.8557919007998319,0.6977602455380656,0.1523809523809524,0
0,0,0,0,0,0.0,0.0,0.0,0
22,76,1672,104,82,0.8889113280770838,0.5911635105834223,0.2894736842105263,0
45,907,40815,131,86,0.8152579007765431,0.6215058580283894,0.04961411245865491,0
0,0,0,0,0,0.0,0.0,0.0,0
0,0,0,0,0,0.0,0.0,0.0,0
0,0,0,0,0,0.0,0.0,0.0,0
0,0,0,0,0,0.0,0.0,0.0,0
0,0,0,0,0,0.0,0.0,0.0,0
0,0,0,0,0,0.0,0.0,0.0,0
0,0,0,0,0,0.0,0.0,0.0,0
21,83,1743,66,45,0.854496544258766,0.686982902134527,0.25301204819277107,0
14,63,882,152,138,0.7862601173872409,0.5518788516371907,0.2222222222222222,0
0,0,0,0,0,0.0,0.0,0.0,0
27,90,2430,150,123,0.6268760221301284,0.307828573244334,0.3,0
40,229,9160,67,27,0.519453358764947,0.4014576378966163,0.17467248908296942,0
16,76,1216,131,115,0.5010390054548036,0.15651376776271742,0.21052631578947367,0
17,56,952,104,87,0.5332943573994322,0.024251597417783585,0.30357142857142855,0
14,66,924,136,122,0.5119291689672754,0.456301954170527,0.21212121212121213,0
13,80,1040,132,119,0.5756599785736007,0.42752687874582385,0.1625,0
24,71,1704,105,81,0.5374852405702748,0.2610009832445339,0.3380281690140845,0
10,71,710,92,82,0.5356324693879266,0.46006979961027594,0.14084507042253522,0
103,166,17098,187,84,0.5386124971608535,0.3013881149695818,0.6204819277108434,1
17,85,1445,138,121,0.5638894904581456,0.4556106588106056,0.2,0
32,211,6752,134,102,0.5874731253898331,0.38088561260257536,0.15165876777251186,0
28,102,2856,106,78,0.6150034353975539,0.3116614480657759,0.27450980392156865,0
10,68,680,88,78,0.5606062386811198,0.37761970686942087,0.14705882352941177,0
16,56,896,129,113,0.4778228834699629,0.25046966029003775,0.2857142857142857,0
19,49,931,134,115,0.4705815625465199,0.15567670578350054,0.3877551020408163,0
15,61,915,130,115,0.496012292629583,0.3952516243500493,0.2459016393442623,0
23,162,3726,133,110,0.5130504155064435,0.03264373094756614,0.1419753086419753,0
17,87,1479,133,116,0.5132033066715002,0.2049160783174018,0.19540229885057472,0
23,115,2645,144,121,0.4935868499861981,0.3190564700345699,0.2,0
15,45,675,107,92,0.5086486818436294,0.4367282746310154,0.3333333333333333,0
21,85,1785,113,92,0.49622555905296717,0.5015937217806252,0.24705882352941178,0
22,91,2002,106,84,0.48582073353363775,0.5413620291215515,0.24175824175824176,0
39,148,5772,108,69,0.4956628377677711,0.4992250937006151,0.2635135135135135,0
31,66,2046,104,73,0.49140088220711475,0.4792199427989177,0.4696969696969697,0
13,59,767,113,100,0.49448269922041516,0.39868220924749753,0.22033898305084745,0
21,46,966,109,88,0.49408321328652627,0.4569225446661201,0.45652173913043476,0
29,58,1682,106,77,0.4926640500437566,0.4365746192620073,0.5,0
14,63,882,101,87,0.48787792621609954,0.3879363055930872,0.2222222222222222,0
21,40,840,107,86,0.5298611254478144,0.4949252068695185,0.525,0
20,53,1060,108,88,0.5288049128956042,0.5613526689304803,0.37735849056603776,0
22,66,1452,67,45,0.6140861926180832,0.43934124528305163,0.3333333333333333,0
19,59,1121,131,112,0.5455256202840105,0.3384335191459351,0.3220338983050847,0
13,85,1105,56,43,0.5470691401602008,0.2901973114092393,0.15294117647058825,0
19,77,1463,139,120,0.47071029894763744,0.2917448809871105,0.24675324675324675,0
12,69,828,132,120,0.4866005674882012,0.18879106510670654,0.17391304347826086,0
12,84,1008,132,120,0.5445567654807696,0.28377692723129305,0.14285714285714285,0
17,89,1513,132,115,0.5100585849605961,0.3157808540837936,0.19101123595505617,0
14,98,1372,99,85,0.5485123336973294,0.4012570435856039,0.14285714285714285,0
41,416,17056,100,59,0.4713770644630397,0.350180800577557,0.0985576923076923,0
10,67,670,126,116,0.5060657378390514,0.5322410319855456,0.14925373134328357,0
18,71,1278,105,87,0.6161773723160907,0.2540237629496693,0.2535211267605634,0
22,64,1408,97,75,0.5056437341176695,0.2307224382903865,0.34375,0
0,0,0,0,0,0.0,0.0,0.0,0
0,0,0,0,0,0.0,0.0,0.0,0
0,0,0,0,0,0.0,0.0,0.0,0
12,56,672,104,92,1.0209289281767284,1.0424712600973984,0.21428571428571427,0
10,71,710,127,117,0.8807241568796585,0.8550028888890681,0.14084507042253522,0
13,68,884,125,112,0.7597182562004553,0.6773632764734056,0.19117647058823528,0
0,0,0,0,0,0.0,0.0,0.0,0
55,44,2420,187,132,0.49480721302996045,0.0,1.25,0
130,62,8060,187,57,0.4887123626867904,0.0,2.096774193548387,0
145,360,52200,187,42,0.25399966943293345,0.0,0.4027777777777778,0
141,72,10152,187,46,0.3629337060867388,0.0,1.9583333333333333,0
137,69,9453,187,50,0.5756972277554885,0.0,1.9855072463768115,0
145,99,14355,187,42,0.2576997175351566,0.0,1.4646464646464648,0
183,59,10797,187,4,0.32838859216909805,0.0,3.1016949152542375,0
183,62,11346,187,4,0.49887260314099746,0.07336364236514467,2.9516129032258065,0
183,198,36234,187,4,0.2471665131408211,0.0,0.9242424242424242,0
147,162,23814,187,40,0.2446789608750768,0.0,0.9074074074074074,0
58,58,3364,187,129,0.9707591275261866,0.07998579002990919,1.0,0
22,50,1100,187,165,0.788991401918356,0.23942921328651476,0.44,0
24,39,936,187,163,0.7954912993786022,0.12230073727508398,0.6153846153846154,0
56,53,2968,187,131,0.7099041166794555,0.09906294535951518,1.0566037735849056,0
15,48,720,187,172,0.696583982530905,0.27402073406739,0.3125,0
0,0,0,0,0,0.0,0.0,0.0,0
58,60,3480,187,129,0.6716628659241911,0.23559452808148215,0.9666666666666667,0
13,62,806,127,114,0.8088432228978784,0.8503099399404871,0.20967741935483872,0
54,86,4644,187,133,1.1081449937349035,0.5854930460522182,0.627906976744186,1
15,103,1545,130,115,0.6979878338503902,0.5424879112168908,0.14563106796116504,0
13,81,1053,129,116,0.6265523016491167,0.6016299267309003,0.16049382716049382,0
20,68,1360,131,111,0.6772114797542994,0.5558524504500929,0.29411764705882354,0
32,71,2272,128,96,0.6357364495632192,0.6592738045120037,0.4507042253521127,0
15,87,1305,136,121,0.6654170654711508,0.61221215224385,0.1724137931034483,0
11,65,715,130,119,0.6192408700685043,0.38511249912894047,0.16923076923076924,0
14,70,980,131,117,0.5466203854233316,0.15943494252935808,0.2,0
17,38,646,132,115,0.5375339159362719,0.3709173904707297,0.4473684210526316,0
38,109,4142,82,44,0.4614222225133789,0.19767782285586016,0.3486238532110092,0
18,54,972,129,111,0.5535486254696754,0.31377073145238776,0.3333333333333333,0
15,90,1350,131,116,0.5078693638055967,0.3745726326806926,0.16666666666666666,0
19,82,1558,133,114,0.5026827042913905,0.25183945349932557,0.23170731707317074,0
18,61,1098,131,113,0.5435502286731748,0.27390793258936147,0.29508196721311475,0
33,360,11880,113,80,0.5365436719576364,0.34540387914748855,0.09166666666666666,0
26,164,4264,106,80,0.579074375432634,0.3784453346017129,0.15853658536585366,0
15,86,1290,127,112,0.4857573651944357,0.21266735012130936,0.1744186046511628,0
23,62,1426,106,83,0.5440703171390177,0.29220487260627936,0.3709677419354839,0
15,101,1515,129,114,0.5268119567906383,0.3542822524363021,0.1485148514851485,0
43,380,16340,110,67,0.7046509351697072,0.42337581377251576,0.11315789473684211,0
32,424,13568,155,123,0.8800221473513373,0.5538863351946818,0.07547169811320754,0
19,101,1919,152,133,0.800585587349421,0.5063971773949226,0.18811881188118812,0
17,112,1904,154,137,1.5678513054853478,0.7104695060437031,0.15178571428571427,1
25,92,2300,105,80,0.5961880637623014,0.4981986296377392,0.2717391304347826,0
20,93,1860,99,79,0.5121006821756077,0.5280841005062773,0.21505376344086022,0
12,65,780,125,113,0.5595641819535407,0.41459107365201003,0.18461538461538463,0
12,51,612,122,110,0.5543028240397374,0.4041110110719856,0.23529411764705882,0
14,73,1022,154,140,0.9650773281344687,0.4995959968405192,0.1917808219178082,0
23,153,3519,154,131,1.0796228236480265,0.8684343421793829,0.1503267973856209,0
24,141,3384,153,129,0.859788368745433,0.5821644036298136,0.1702127659574468,0
20,80,1600,153,133,0.873011814380525,0.5988631063024101,0.25,0
23,132,3036,103,80,0.63842243785195,0.43252453780258737,0.17424242424242425,0
0,0,0,0,0,0.0,0.0,0.0,0
17,120,2040,103,86,0.8344308110611779,0.7744156276060467,0.14166666666666666,0
0,0,0,0,0,0.0,0.0,0.0,0
0,0,0,0,0,0.0,0.0,0.0,0
0,0,0,0,0,0.0,0.0,0.0,0
0,0,0,0,0,0.0,0.0,0.0,0
11,72,792,101,90,0.7332449831031657,0.8447162855544297,0.1527777777777778,0
0,0,0,0,0,0.0,0.0,0.0,0
0,0,0,0,0,0.0,0.0,0.0,0
0,0,0,0,0,0.0,0.0,0.0,0
0,0,0,0,0,0.0,0.0,0.0,0
0,0,0,0,0,0.0,0.0,0.0,0
0,0,0,0,0,0.0,0.0,0.0,0
27,159,4293,106,79,0.740379823675959,0.7057852423692973,0.16981132075471697,0
20,76,1520,129,109,0.9352893156323988,0.4704839074416656,0.2631578947368421,0
0,0,0,0,0,0.0,0.0,0.0,0
0,0,0,0,0,0.0,0.0,0.0,0
20,137,2740,104,84,0.9571022701565107,0.9961474355582983,0.145985401459854,0
0,0,0,0,0,0.0,0.0,0.0,0
0,0,0,0,0,0.0,0.0,0.0,0
16,108,1728,105,89,0.8167372859412847,0.7314494425620985,0.14814814814814814,0
0,0,0,0,0,0.0,0.0,0.0,0
11,59,649,104,93,0.7461830143288236,0.7718468476299033,0.1864406779661017,0
19,67,1273,151,132,1.3947377905078884,1.0573519885246085,0.2835820895522388,0
43,352,15136,155,112,0.9417788126638436,0.8026545550079619,0.12215909090909091,0
23,125,2875,155,132,1.05994115495577,0.8404206753118402,0.184,0
15,85,1275,104,89,1.1164471920639496,1.3545461904478318,0.17647058823529413,0
17,110,1870,129,112,0.8617877250155486,0.795967148586525,0.15454545454545454,0
12,74,888,126,114,0.7019745887106614,0.5958892657533638,0.16216216216216217,0
11,61,671,132,121,0.6685630986993788,0.5935071157768165,0.18032786885245902,0
0,0,0,0,0,0.0,0.0,0.0,0
0,0,0,0,0,0.0,0.0,0.0,0
0,0,0,0,0,0.0,0.0,0.0,0
0,0,0,0,0,0.0,0.0,0.0,0
41,720,29520,130,89,1.1367515361077316,1.1674198894623273,0.05694444444444444,0
15,54,810,147,132,1.0165059160275232,0.23638780994087752,0.2777777777777778,0
34,279,9486,118,84,0.7764835153692352,0.7636094837068953,0.12186379928315412,0
0,0,0,0,0,0.0,0.0,0.0,0
0,0,0,0,0,0.0,0.0,0.0,0
0,0,0,0,0,0.0,0.0,0.0,0
34,295,10030,67,33,1.4943085112697818,1.640716484329615,0.1152542372881356,0
42,670,28140,128,86,1.1479012852420536,1.1658699596091706,0.0626865671641791,0
43,429,18447,129,86,0.8609373922659995,0.9281441099731079,0.10023310023310024,0
19,87,1653,63,44,0.8431833222218356,0.7447696109620042,0.21839080459770116,0
0,0,0,0,0,0.0,0.0,0.0,0
44,1164,51216,129,85,0.7137056634046239,0.7034082025419278,0.037800687285223365,0
37,263,9731,129,92,0.6675786530351292,0.5041360138157361,0.14068441064638784,0
14,61,854,69,55,0.5896156834918564,0.3038452058395849,0.22950819672131148,0
16,78,1248,106,90,0.6018337077936639,0.40001900463088413,0.20512820512820512,0
36,481,17316,147,111,0.6247872954558715,0.5331003886742515,0.07484407484407485,0
16,66,1056,133,117,0.5900814948762171,0.5520815376480729,0.24242424242424243,0
18,67,1206,122,104,0.6281864080463943,0.3059884330906758,0.26865671641791045,0
31,323,10013,154,123,1.0194929562908674,0.6145455511817328,0.09597523219814241,0
36,494,17784,153,117,0.6235829792914688,0.31437257876605096,0.0728744939271255,0
22,99,2178,153,131,0.6248312827277753,0.4137624290139383,0.2222222222222222,0
0,0,0,0,0,0.0,0.0,0.0,1
13,92,1196,127,114,0.5844130885367184,0.4298443825622127,0.14130434782608695,0
41,275,11275,140,99,0.6204683361791177,0.5018469331510699,0.14909090909090908,0
18,120,2160,135,117,0.5618290432111949,0.4890787956855075,0.15,0
0,0,0,0,0,0.0,0.0,0.0,0
0,0,0,0,0,0.0,0.0,0.0,0
0,0,0,0,0,0.0,0.0,0.0,0
37,706,26122,130,93,0.7609657133641368,0.7096357796118773,0.05240793201133145,0
10,70,700,186,176,0.9150011881212252,0.4856728964416474,0.14285714285714285,1
14,82,1148,118,104,1.0176774236471915,0.7136162783637334,0.17073170731707318,0
0,0,0,0,0,0.0,0.0,0.0,0
11,65,715,64,53,0.7573271910579277,0.7743451027589239,0.16923076923076924,0
0,0,0,0,0,0.0,0.0,0.0,0
21,121,2541,66,45,0.7942641792259466,0.7218008707618495,0.17355371900826447,0
0,0,0,0,0,0.0,0.0,0.0,0
15,82,1230,65,50,0.9641083161209223,0.6107950827311549,0.18292682926829268,0
18,127,2286,104,86,0.7205959129549232,0.5916872745397083,0.14173228346456693,0
0,0,0,0,0,0.0,0.0,0.0,0
20,91,1820,62,42,0.6680099304164256,0.41039489618098635,0.21978021978021978,0
0,0,0,0,0,0.0,0.0,0.0,0
0,0,0,0,0,0.0,0.0,0.0,0
14,65,910,59,45,0.6429626762353747,0.3426970963775724,0.2153846153846154,0
0,0,0,0,0,0.0,0.0,0.0,0
80,127,10160,187,107,0.6498827229363116,0.3015848921285544,0.6299212598425197,0
20,112,2240,66,46,0.6877801168162179,0.456607619472277,0.17857142857142858,0
10,65,650,136,126,0.6563645064106327,0.6071836484758385,0.15384615384615385,0
10,65,650,131,121,0.6381837297141544,0.6739824020443297,0.15384615384615385,0
40,102,4080,187,147,0.77138391215911,0.4633084057150568,0.39215686274509803,0
14,99,1386,133,119,0.6104928825743755,0.39354199995969974,0.1414141414141414,0
42,650,27300,138,96,0.5947974286351658,0.3880514099220304,0.06461538461538462,0
49,280,13720,129,80,0.540213028580019,0.007225434364266048,0.175,0
13,59,767,68,55,0.60953066959758,0.22720923590282327,0.22033898305084745,0
12,57,684,56,44,0.6302980561592291,0.420064257943709,0.21052631578947367,0
16,112,1792,131,115,0.6255443407766749,0.1648624563732338,0.14285714285714285,0
24,48,1152,187,163,0.5153327482865269,0.3640392116197345,0.5,0
14,69,966,97,83,0.5184624531177692,0.25712522709284297,0.2028985507246377,0
33,442,14586,107,74,0.5867664256256819,0.38552785598412553,0.0746606334841629,0
16,49,784,127,111,0.5307509046822524,0.3166594376781758,0.32653061224489793,0
32,456,14592,62,30,0.5195490526228749,0.32812744791182524,0.07017543859649122,0
13,71,923,104,91,0.5569786744856101,0.38811817946646365,0.18309859154929578,0
31,504,15624,115,84,0.5693803447959828,0.3332776642386794,0.061507936507936505,0
80,73,5840,187,107,0.8952738161396167,0.39934805793640465,1.095890410958904,1
11,70,770,154,143,0.7534015316832066,0.46920030181970135,0.15714285714285714,0
24,57,1368,186,162,0.6122295807363165,0.5996311861438178,0.42105263157894735,0
14,100,1400,143,129,0.5965267535046249,0.15719074928187685,0.14,0
25,145,3625,154,129,0.5482145650824041,0.15931993083357454,0.1724137931034483,0
57,68,3876,187,130,0.6062030125942461,0.38035800460973523,0.8382352941176471,1
23,41,943,103,80,0.4780471749087033,0.41043427231977364,0.5609756097560976,0
31,501,15531,106,75,0.5209837958761867,0.40745654434432577,0.06187624750499002,0
12,81,972,102,90,0.5828114952673042,0.25940929153910136,0.14814814814814814,0
31,668,20708,135,104,0.5673413971287713,0.28500341419626285,0.04640718562874251,0
47,322,15134,134,87,0.5365724987565962,0.20407585903439532,0.14596273291925466,0
13,77,1001,114,101,0.6000785482746299,0.4455309309539415,0.16883116883116883,0
46,709,32614,128,82,0.6923298251189839,0.541900944280975,0.06488011283497884,0
47,365,17155,131,84,0.6646696604163925,0.4531604342091397,0.12876712328767123,0
37,476,17612,120,83,0.5984843751949112,0.274279983003737,0.07773109243697479,0
61,115,7015,187,126,1.669383250501578,1.3925469287376449,0.5304347826086957,1
59,169,9971,187,128,1.0282636911249794,0.6131041128918026,0.34911242603550297,1
0,0,0,0,0,0.0,0.0,0.0,0
22,76,1672,67,45,0.8659633581544363,0.5183696830025578,0.2894736842105263,0
12,67,804,124,112,0.5458546423693219,0.4547797413282469,0.1791044776119403,0
20,81,1620,103,83,0.790398568612723,0.5712942491172759,0.24691358024691357,0
0,0,0,0,0,0.0,0.0,0.0,0
0,0,0,0,0,0.0,0.0,0.0,0
0,0,0,0,0,0.0,0.0,0.0,0
20,99,1980,62,42,0.8392899068695341,0.5302442662400418,0.20202020202020202,0
22,104,2288,63,41,1.008917626762751,0.8969078838059855,0.21153846153846154,0
0,0,0,0,0,0.0,0.0,0.0,0
0,0,0,0,0,0.0,0.0,0.0,0
0,0,0,0,0,0.0,0.0,0.0,0
11,67,737,58,47,0.9246284728226073,0.4251243330279639,0.16417910447761194,0
0,0,0,0,0,0.0,0.0,0.0,0
35,294,10290,118,83,0.821796144442131,0.6830608420970764,0.11904761904761904,0
0,0,0,0,0,0.0,0.0,0.0,0
33,825,27225,114,81,1.0558853986705066,1.076479578813767,0.04,0
0,0,0,0,0,0.0,0.0,0.0,0
0,0,0,0,0,0.0,0.0,0.0,0
0,0,0,0,0,0.0,0.0,0.0,0
12,85,1020,61,49,0.8845680845595861,1.0134672002931167,0.1411764705882353,0
0,0,0,0,0,0.0,0.0,0.0,0
14,80,1120,56,42,0.8905722884843227,0.5999229276356529,0.175,0
0,0,0,0,0,0.0,0.0,0.0,0
0,0,0,0,0,0.0,0.0,0.0,0
16,113,1808,119,103,0.9189885503174808,0.9817880492586487,0.1415929203539823,0
0,0,0,0,0,0.0,0.0,0.0,0
19,105,1995,128,109,0.7807632939945169,0.5632734683585172,0.18095238095238095,0
13,59,767,63,50,0.6299561119051169,0.5140549757739882,0.22033898305084745,0
0,0,0,0,0,0.0,0.0,0.0,0
11,55,605,91,80,0.6648008752918424,0.4285360501832734,0.2,0
0,0,0,0,0,0.0,0.0,0.0,0
0,0,0,0,0,0.0,0.0,0.0,0
23,76,1748,126,103,0.6004205046330731,0.29115222000491925,0.3026315789473684,0
0,0,0,0,0,0.0,0.0,0.0,0
0,0,0,0,0,0.0,0.0,0.0,0
13,72,936,62,49,0.6959194208744165,0.6359343409988039,0.18055555555555555,0
0,0,0,0,0,0.0,0.0,0.0,0
19,63,1197,65,46,0.7376968009576477,0.4079111048279779,0.30158730158730157,0
12,77,924,56,44,0.5715155345091854,0.49922638420145016,0.15584415584415584,0
0,0,0,0,0,0.0,0.0,0.0,0
0,0,0,0,0,0.0,0.0,0.0,0
0,0,0,0,0,0.0,0.0,0.0,0
0,0,0,0,0,0.0,0.0,0.0,0
0,0,0,0,0,0.0,0.0,0.0,0
21,72,1512,65,44,0.9415638365106572,0.07379864276929739,0.2916666666666667,0
11,65,715,60,49,0.7448436966941341,0.47885428599896007,0.16923076923076924,0
31,478,14818,129,98,0.701897908890742,0.7311874923873023,0.06485355648535565,0
0,0,0,0,0,0.0,0.0,0.0,0
0,0,0,0,0,0.0,0.0,0.0,0
12,78,936,127,115,0.8064907674152819,0.8675695797428337,0.15384615384615385,0
23,66,1518,128,105,0.5718313324177906,0.5007974707382354,0.3484848484848485,0
0,0,0,0,0,0.0,0.0,0.0,0
0,0,0,0,0,0.0,0.0,0.0,0
16,92,1472,128,112,0.6865819551597875,0.6824049481999034,0.17391304347826086,0
19,132,2508,125,106,1.3496489173640012,1.0001562866306295,0.14393939393939395,0
18,99,1782,121,103,0.7648277226555487,0.6700767240895625,0.18181818181818182,0
0,0,0,0,0,0.0,0.0,0.0,0
0,0,0,0,0,0.0,0.0,0.0,0
24,107,2568,66,42,0.960247892466376,0.9779515363523442,0.22429906542056074,0
20,118,2360,64,44,0.8153392310321095,0.7507543879685467,0.1694915254237288,0
12,58,696,120,108,0.993872295860503,0.5867114627761072,0.20689655172413793,0
51,38,1938,187,136,0.3044369541768311,0.0,1.3421052631578947,0
78,38,2964,187,109,0.33318594015278713,0.0,2.0526315789473686,0
143,69,9867,187,44,0.28821723859187554,0.0,2.072463768115942,0
19,58,1102,106,87,0.6389329646145637,0.41661816277850006,0.3275862068965517,0
143,404,57772,187,44,0.28502289748940923,0.053758946711775994,0.35396039603960394,0
29,68,1972,138,109,0.5666206540782917,0.3646654237293343,0.4264705882352941,0
20,73,1460,132,112,0.5072569162045825,0.2780927350742382,0.273972602739726,0
52,61,3172,141,89,0.4867219138544939,0.0,0.8524590163934426,0
15,83,1245,65,50,0.6675651183007988,0.5982453473989958,0.18072289156626506,0
16,72,1152,65,49,0.7134767900215321,0.6783600362870457,0.2222222222222222,0
17,60,1020,104,87,0.6255266485466978,0.1347602562737533,0.2833333333333333,0
23,49,1127,69,46,0.5102150977207324,0.28690792351392574,0.46938775510204084,0
10,61,610,176,166,0.8138094409120962,0.5455708524599121,0.16393442622950818,0
22,83,1826,131,109,0.6216649962809078,0.522379310238338,0.26506024096385544,0
0,0,0,0,0,0.0,0.0,0.0,0
43,850,36550,131,88,0.5236713511497662,0.31660254482855754,0.05058823529411765,0
10,64,640,177,167,0.7703330789605513,0.8242793872916773,0.15625,0
15,48,720,130,115,0.5865464407293183,0.3903677812674347,0.3125,0
17,108,1836,130,113,0.6184718533838117,0.5265980997562691,0.1574074074074074,0
12,58,696,178,166,0.6595095826988635,0.5928004305904774,0.20689655172413793,0
10,63,630,177,167,0.7683442475185932,0.505447407047349,0.15873015873015872,0
13,68,884,178,165,0.6896786397276774,0.5762885935966449,0.19117647058823528,0
11,66,726,177,166,0.8257977084178865,0.6839288158821828,0.16666666666666666,0
15,67,1005,179,164,0.6095910741930984,0.0,0.22388059701492538,0
12,78,936,106,94,0.7458392521337279,0.7461780376291606,0.15384615384615385,0
16,99,1584,135,119,0.5408043695016801,0.3900200309049771,0.16161616161616163,0
20,98,1960,129,109,0.9272536335055944,0.5669401195576602,0.20408163265306123,0
14,60,840,135,121,0.5294034051808175,0.23515254175176326,0.23333333333333334,0
12,81,972,137,125,0.5483266621833417,0.285520687103827,0.14814814814814814,0
14,51,714,131,117,0.5202226409240703,0.26932631300759513,0.27450980392156865,0
13,69,897,132,119,0.5468746415338562,0.45128849806721427,0.18840579710144928,0
14,91,1274,126,112,0.5445972423306069,0.39179419182702646,0.15384615384615385,0
20,113,2260,134,114,0.5285051988041299,0.177228960696845,0.17699115044247787,0
14,47,658,134,120,0.510257209298082,0.14705058863546772,0.2978723404255319,0
13,52,676,131,118,0.48301006424370757,0.1610786874631909,0.25,0
13,73,949,86,73,0.4912872361525435,0.4120198934927524,0.1780821917808219,0
24,69,1656,100,76,0.5294270561606037,0.3560978055577165,0.34782608695652173,0
20,71,1420,67,47,0.5325580191263773,0.2675661737066031,0.28169014084507044,0
24,151,3624,130,106,0.6499167980466171,0.2071457375963877,0.15894039735099338,0
31,197,6107,131,100,0.501262268444922,0.2119669192209745,0.15736040609137056,0
14,80,1120,129,115,0.4930094697491214,0.2055927043789018,0.175,0
22,87,1914,135,113,0.4791748685541507,0.20868348712694015,0.25287356321839083,0
17,114,1938,128,111,0.5495058293638394,0.09881380757899225,0.14912280701754385,0
11,71,781,132,121,0.5924920870665333,0.1880487744048297,0.15492957746478872,0
30,58,1740,107,77,0.48679020393533656,0.3832268872263577,0.5172413793103449,0
25,105,2625,64,39,0.47620564574954954,0.17104408651909778,0.23809523809523808,0
31,295,9145,134,103,0.5016982154615192,0.1731601474974489,0.10508474576271186,0
23,89,2047,68,45,0.5303707637074005,0.2553012390948712,0.25842696629213485,0
31,539,16709,134,103,0.5558081573487014,0.28428662490936624,0.0575139146567718,0
11,61,671,127,116,0.5443683131377117,0.3235513902591531,0.18032786885245902,0
21,149,3129,139,118,0.46760131321956155,0.16346014884110274,0.14093959731543623,0
25,158,3950,140,115,0.4720804408947845,0.08746597178889998,0.15822784810126583,0
10,66,660,127,117,0.6250780417775061,0.45130519193905033,0.15151515151515152,0
17,59,1003,116,99,0.5035525477612264,0.1542013986130194,0.288135593220339,0
16,94,1504,126,110,0.5274352447495977,0.14059481705072144,0.1702127659574468,0
11,78,858,123,112,0.5579277953600776,0.5151310788856326,0.14102564102564102,0
13,57,741,95,82,0.6264004787991623,0.36831300180422644,0.22807017543859648,0
27,59,1593,128,101,0.5212116014098463,0.24250494138805603,0.4576271186440678,0
31,522,16182,133,102,0.6126625265995096,0.43132615648049877,0.05938697318007663,0
29,86,2494,131,102,0.537608021356853,0.2668647065007132,0.3372093023255814,0
27,148,3996,132,105,0.5372632326340762,0.23579404511872423,0.18243243243243243,0
55,239,13145,137,82,0.4784823081076542,0.23555733900112902,0.2301255230125523,0
33,405,13365,68,35,0.578134177200009,0.2676405718992709,0.08148148148148149,0
13,71,923,105,92,0.5782924543813778,0.16969549088053507,0.18309859154929578,0
24,100,2400,138,114,0.6584690042547565,0.39430986596897527,0.24,0
40,474,18960,129,89,0.5873302604527699,0.39314012491397204,0.08438818565400844,0
14,83,1162,129,115,0.6003902724865982,0.377596164445591,0.1686746987951807,0
19,131,2489,130,111,0.5478408934449553,0.5416520899630839,0.1450381679389313,0
15,95,1425,127,112,0.6330471888898096,0.31015642868749377,0.15789473684210525,0
31,112,3472,111,80,0.6464928483032856,0.14435703300772862,0.2767857142857143,0
13,53,689,124,111,0.5570315996670074,0.4277496524402915,0.24528301886792453,0
28,102,2856,82,54,0.5254724526359188,0.42719576565598166,0.27450980392156865,0
11,63,693,130,119,0.5982331023128575,0.4847987231211101,0.1746031746031746,0
13,55,715,70,57,0.6995787396323953,0.3975363244296832,0.23636363636363636,0
18,108,1944,131,113,0.5252209212133119,0.3985053585502963,0.16666666666666666,0
39,173,6747,124,85,0.5316967750113906,0.23627303263409172,0.2254335260115607,0
45,169,7605,129,84,0.45217591171601257,0.16439061781746048,0.26627218934911245,0
0,0,0,0,0,0.0,0.0,0.0,0
46,95,4370,130,84,0.7545687917180359,0.36418427892327904,0.4842105263157895,1
0,0,0,0,0,0.0,0.0,0.0,0
21,72,1512,106,85,1.044543797114606,0.7783073332058227,0.2916666666666667,0
0,0,0,0,0,0.0,0.0,0.0,0
0,0,0,0,0,0.0,0.0,0.0,0
0,0,0,0,0,0.0,0.0,0.0,0
0,0,0,0,0,0.0,0.0,0.0,0
0,0,0,0,0,0.0,0.0,0.0,0
0,0,0,0,0,0.0,0.0,0.0,0
20,104,2080,65,45,0.8186472800629107,0.6974868352518054,0.19230769230769232,0
0,0,0,0,0,0.0,0.0,0.0,0
13,72,936,187,174,1.1280493232882918,1.230855173177219,0.18055555555555555,1
28,84,2352,111,83,0.9589442032395947,0.6918258135085154,0.3333333333333333,0
0,0,0,0,0,0.0,0.0,0.0,0
20,63,1260,104,84,0.9548283680600372,0.3159482583730823,0.31746031746031744,0
47,164,7708,123,76,0.5794850887632759,0.3083172392620114,0.2865853658536585,0
16,77,1232,131,115,0.5884166871388337,0.37005712809540714,0.2077922077922078,0
18,97,1746,98,80,0.6376258047907778,0.4839498289799109,0.18556701030927836,0
15,70,1050,133,118,0.554356711025848,0.4321441949273626,0.21428571428571427,0
22,146,3212,131,109,0.6133780082462393,0.18391045062097133,0.1506849315068493,0
35,254,8890,65,30,0.5540788040533313,0.2971660628178154,0.1377952755905512,0
18,82,1476,107,89,0.6348300217351832,0.48553068443775715,0.21951219512195122,0
16,86,1376,154,138,1.2104827084426941,0.6752869373936832,0.18604651162790697,0
26,125,3250,130,104,0.799951968940108,0.3743934965811135,0.208,0
50,546,27300,139,89,0.5627703505897375,0.4299385444087577,0.09157509157509157,0
51,282,14382,134,83,0.6288316430276593,0.47740978840931386,0.18085106382978725,0
32,252,8064,136,104,0.5768736886911098,0.3310850860479054,0.12698412698412698,0
24,69,1656,105,81,0.6261461601401866,0.3344179795073263,0.34782608695652173,0
18,106,1908,130,112,0.5532564389415726,0.2816817994144246,0.16981132075471697,0
51,167,8517,127,76,0.4876601616067107,0.24203652108204612,0.30538922155688625,0
15,49,735,103,88,0.5093212803204885,0.4565045997783364,0.30612244897959184,0
30,155,4650,114,84,0.5310465562169584,0.388227901793352,0.1935483870967742,0
11,65,715,131,120,0.5426188621392505,0.4023655632642371,0.16923076923076924,0
11,63,693,134,123,0.5494697494095094,0.23229124723430322,0.1746031746031746,0
25,74,1850,105,80,0.4920102214756197,0.35501196240136534,0.33783783783783783,0
26,83,2158,107,81,0.5366507033072959,0.5249978597734305,0.3132530120481928,0
19,78,1482,107,88,0.48816881177359966,0.4410859580185641,0.24358974358974358,0
11,56,616,102,91,0.4873252646604255,0.3496416421531951,0.19642857142857142,0
11,73,803,109,98,0.5068319912775376,0.5815654616217254,0.1506849315068493,0
20,45,900,101,81,0.48958463528150875,0.4154142184271291,0.4444444444444444,0
17,82,1394,109,92,0.484817549046937,0.48326723878730865,0.2073170731707317,0
28,88,2464,107,79,0.49530704058851405,0.4489984796390244,0.3181818181818182,0
12,60,720,130,118,0.5466028273886625,0.3223611275615304,0.2,0
13,80,1040,131,118,0.554149017021055,0.02648649994967234,0.1625,0
43,318,13674,69,26,0.5709323331801675,0.37799174268137997,0.13522012578616352,0
41,580,23780,67,26,0.5786509839146076,0.3591137222446716,0.0706896551724138,0
18,89,1602,106,88,0.5376404377634808,0.0,0.20224719101123595,0
32,191,6112,133,101,0.53614008173115,0.29860037924173854,0.16753926701570682,0
24,126,3024,130,106,0.626992970641456,0.5846831683613966,0.19047619047619047,0
45,260,11700,130,85,0.6088595240075325,0.4287372936089285,0.17307692307692307,0
42,125,5250,129,87,0.6766370520300922,0.23699205066852025,0.336,0
34,91,3094,82,48,0.550001181104947,0.43769073763691074,0.37362637362637363,0
22,84,1848,106,84,0.6275503461861365,0.33695507996078206,0.2619047619047619,0
0,0,0,0,0,0.0,0.0,0.0,0
21,138,2898,107,86,0.6231047660518856,0.45974615044101363,0.15217391304347827,0
24,85,2040,106,82,0.7320388716349611,0.7096721513858618,0.2823529411764706,0
22,87,1914,65,43,0.7446783248470525,0.7933101042561286,0.25287356321839083,0
